0-8 = 0-8
9-11 = 9-11
bw5clef(p1) = esta voz é um Blackwood a 5 cartas chave em trunfo %p1% : pergunta ao parceiro quantas chaves tem, com trunfo %p1%. As 5 chaves são os 4 Ases + o rei de trunfo (rei de %p1%).

[forcing]
forcing10=Voz "Não Forcing"
forcing11=Voz "Forcing"
forcing12=Voz "Forcing de Partida"
forcing13="Forcing de passo"
forcing20=Voz "Não Forcing"
forcing21=Voz "Forcing"
forcing22=Voz "Forcing de Partida"
forcing23="Forcing de passo"


[General]
&=e
|=ou
T=Pau
K=Ouro
C=Copa
P=Espada
nat=esta voz é natural
exactcoul(p1,p2)=exatamente %p1% cartas de %p2%
coul(p1,p2)=pelo menos %p1% cartas de %p2%
sanscoul(p1,p2)=esta voz nega %p1% cartas de %p2%
courte(p1)=curto a %p1% (singleton ou chicana)
singleton(p1)=um singleton a %p1%
irreg=uma mão desbalançada
reg=uma mão balançada
arret=uma paragem no naipe do adversário (As, Rei doubleton, Dama à terceira ou valete à quarta, pelo menos)
arret(p1)=uma paragem a %p1%
pb=falta de uma paragem no naipe marcado, à procura de jogar 3ST, o parceiro deve marcar 3ST com força nesse naipe.
pb(p1)=falta de paragem a %p1%
force(p1)=força a %p1%, ou seja, uma honra ou concentração de honras
ouvsa=uma mão balançada em princípio sem naipe rico quinto
sa=uma mão tendencialmente balançada sem um naipe rico de quatro cartas anunciável ao nível 1
tolerance(p1)=tolerância pelos %p1%
pref=uma preferência pelo naipe marcado
pref(p1)=uma preferência pelos %p1%
paspref=uma mão sem preferência por nenhum dos naipes do parceiro
fit(p1)=um fit a %p1%
fit=um fit
fitjump=longo (excecionalmente uma força) no naipe marcado e um fit no naipe do parceiro
sansfit=esta voz nega um fit
bic(p1,p2)=um bicolor %p1%/%p2%
bicdeuxautres=um bicolor dos dois naipes ainda não marcados
bicinde=um bicolor com o outro naipe rico e um pobre indeterminado
bicpolish=um bicolor indeterminado com pelo menos um rico
bicsixquatre=um bicolor com os dois naipes não marcados, 6 cartas no naipe maios económico e 4 cartas no naipe mais rico
maj(p1)=%p1% cartas num rico
tricolore=um jogo tricolor (três naipes de quatro cartas)
mauvaisatouts=trunfos de má qualidade
belle(p1,p2)=%p1% boas cartas a %p2%
barrage=uma barragem no naipe marcado, ou seja, uma mão fraca em pontos e com um naipe longo
canap=um canapé, ou seja, o segundo naipe mais longo que o primeiro
faible=uma mão fraca
fort=uma mão forte
competitif=uma voz competitiva para não deixar os adversários ganhar o leilão, não mostra necessariamente esperança de partida.
limite=uma mão de convite, ou seja, pede para marcar partida com alguns extras.
essaimanche=uma mão com esperança de partida
manche=uma mão de partida sem esperança de cheleme
chelem=esperança de cheleme
choixchelem=força para jogar cheleme e procurar o melhor naipe de trunfo
maxi=uma mão máxima
mini=uma mão mínima
cher=um bicolor rico (o regresso ao primeiro naipe do abridor implica uma voz ao nível de 3)
eco=um bicolor económico : marcação sem salto de um novo naipe mais económico que o naipe de abertura
saut=um bicolor com salto (o segundo naipe podia ter sido anunciado um nível abaixo)
quantitatif=uma proposta de cheleme se o parceiro não estiver mínimo
dujeu=força extra sem mais indicações
dujeu(p1)=Esta voz mostra valores extra, pelo menos %p1% pontos, sem mais indicações sobre a distribuição.
f=esta voz é forcing (o parceiro não pode passar na próxima voz)
nf=esta voz é não-forcing (o parceiro pode passar na próxima voz)
fp=esta é uma voz de paragem, quer dizer que o parceiro tem a obrigação de a passar na sua próxima voz
fm=esta voz é forcing de partida (o parceiro não pode passar antes de se marcar uma partida)
appel=esta voz é de chamada (mostra apoio em todas as cores que não as do adversário)
entame=esta voz pede ao parceiro para sair neste naipe se os adversários ganharem o leilão e for ele a sair
lightner=esta voz é um dobre lightner : pede ao parceiro para fazer uma saída especial : em geral, o primeiro naipe do morto, ou mostra uma chicana que o parceiro deve tentar encontrar
entamesa=esta voz é um dobre de saída : indica que os adversários provavelmente cabidam se o parceiro fizer uma saída especial : em geral, o primeiro naipe marcado pelo morto
pun=esta voz é punitiva, ou seja, indica que pensamos que os adversários vão cabidar
pundsune=esta voz mostra vontade de punir os adversários em pelo menos um dos naipes restantes
sos=esta voz tem como objetivo fugir para outro naipe de trunfo, pede ao parceiro para nomear um naipe longo
surcontre=esta voz indica que pensamos ganhar o contrato dobrado e propõe ao parceiro que passe ao redobre.
ambigu=esta voz marca um compasso de espera, não mostrando nada em especial
cuebid=esta voz é um cue-bid (anúncio do naipe do adversário) e mostra uma mão forte ou em alternativa uma mão sem uma voz natural disponível (por vezes é uma mão sem defesa no naipe para jogar Sem Trunfo)
cuebidfit=esta voz é um cue-bid (anúncio do naipe do adversário) e mostra uma mão forte fitada
relais=esta voz é um relais : uma espécie de compasso de espera
sansinfo=esta voz não está prevista e não transmite nenhuma informação nova
ras=esta voz não indica nada em particular
pourjouer=esta voz indica o que parece ser o melhor contrato face à sequência do leilão.
obligatoire=esta voz é uma retificação obrigatória
interdit=esta voz é formalmente interdita
bug=BUG : agradecemos que nos reporte este problema
reveil=esta voz é um reveil (feita após dois passes). Pode ser feita com jogos fracos porque se o jogador passar o leilão termina.
poc=esta voz pede ao parceiro para passar ou corrigir, consoante este seja ou não o seu naipe
demandemin=esta voz pede ao parceiro para marcar o seu naipe pobre (paus ou ouros)
demandemaj=esta voz pede ao parceiro para marcar o seu naipe rico (copas ou espadas)
majcinq=sistema de abertura em ricos de 5, ou seja, a abertura em naipe rico (copas ou espadas) promete pelo menos 5 cartas no naipe
polish=voz do sistema polaco
mm=Melhor menor (abre-se no naipe pobre mais longo; em caso de igualdade com paus e ouros de 4 ou + cartas abre-se em 1 Ouro, com 3-3 abre-se em 1 Pau)
multi=esta voz é artificial, mostra uma mão fraca com copas ou espadas
deuxpolo=esta voz mostra uma mão fraca com 5 cartas no naipe marcado e um naipe pobre (paus ou ouros) de 5 cartas
deuxpolomaj=esta voz mostra um bicolor com copas e outro naipe indeterminado
kquatre=sistema de abertura em Ouros de 4, a voz de 1 Ouro promete pelo menos 4 cartas no naipe
drury=esta voz é artificial, designa-se por Drury e mostra uma mão passada com um máximo dentro do passo e um fit no naipe de abertura
troisf=esta voz designa-se por "terceiro naipe forcing", mostra uma falta de stoppers no quarto naipe, ou pesquisa um fit, ou corresponde a uma mão forte que pretende tornar a sequência do leilão forcing antes de mostrar o fit
troisfdeuxsurun=esta voz designa-se por "terceiro naipe forcing" : pode ser natural, ou mostrar uma falta de stoppers no quarto naipe
quatriemef=esta voz designa-se por "quarto naipe forcing", mostra uma falta de stoppers no naipe marcado, ou pesquisa um fit, ou corresponde a uma mão forte que pretende tornar a sequência do leilão forcing antes de mostrar o fit
spoutnik=esta voz é artificial, designa-se por "spoutnik", mostra cerca de oito pontos no mínimo sem limite superior e promete pelo menos quatro cartas num naipe não marcado
fortinde=esta voz mostra uma mão forte com um naipe longo indeterminado ou uma mão balançada com 22-23 pontos de honras
gambling=esta voz mostra um naipe pobre (paus ou ouros) sólido de sete cartas (ARDxxxx)
landy=esta voz é artificial, designa-se por Landy, mostra um bicolor com pelo menos 4 copas e 4 espadas
deuxsafit=um fit, numa mão de convite a partida com 3 trunfos, ou uma mão balançada com 12-14H
splinter=esta voz é artificial, designa-se por Splinter, mostra um singleton ou chicana no naipe marcado e um bom fit no último naipe marcado pelo parceiro
roudi=esta voz é artificial, designa-se por "roudi" : mostra uma mão de pelo menos convite a partida e pergunta ao parceiro se tem 3 cartas de apoio para o nosso naipe
leben=esta voz é artificial, designa-se por Lebensohl : 2ST mostra uma mão fraca, e outras vozes nesta situação mostram uma mão forte
truscott=esta voz é artificial, designa-se por Truscott : 2ST mostra uma mão fitada com pelo menos um convite a partida, e o fit ao nível de 3 mostra uma mão fraca
moderateur=esta voz é artificial, designa-se por "2ST moderador" : mostra em geral uma mão fraca e pede ao parceiro para remarcar o seu naipe mais longo com um jogo mínimo
josephine=esta voz é convencional, designa-se por "Josefina" : pede ao parceiro para marcar o grande cheleme com duas grandes honras (de ARD) no naipe de trunfo, ou 6ST com o Ás ou Rei de trunfo e comprimento extra em trunfo.
josephine6T=esta resposta é convencional, designa-se por "Josefina" : indica o Ás ou Rei de trunfo e comprimento extra em trunfo.
stayman=esta voz é convencional, designa-se por Stayman : pergunta ao parceiro se tem um naipe rico (copas ou espadas) de quatro cartas e garante pelo menos uma mão de convite a partida e um naipe rico com exatamente quatro cartas.
staymanrep=esta voz nega quatro cartas a copas ou a espadas.
texas(p1)=esta voz é artificial, designa-se por "Texas" : indica um naipe longo a %p1% sem indicação de força da mão
transfert(p1)=esta voz é um transfer que pede ao parceiro para marcar %p1%, para ser o abridor a cartear, e fixa o trunfo em %p1%
bw=esta voz é a convenção Blackwood : pergunta ao parceiro quantos Ases tem
bwrois=esta voz é o convenção Blackwood para Reis : pergunta ao parceiro quantos reis tem
bw(p1)=esta voz é a convenção Blackwood (pergunta ao parceiro quantos Ases tem), com trunfo %p1%
bwda=esta voz pergunta se o parceiro tem a Dama de trunfo
as(p1,p2)=esta voz mostra %p1% ou %p2% As(es)
roi(p1,p2)=esta voz mostra %p1% ou %p2% Rei(s)
clef(p1,p2)=esta voz mostra %p1% ou %p2% chave(s). As 5 chaves são os 4 Ases e o rei de trunfo
as(p1)=esta voz mostra %p1% As(es)
clef(p1)=esta voz mostra %p1% chave(s). As 5 chaves são os 4 Ases e o rei de trunfo
roi(p1)=esta voz mostra %p1% Rei(s)
ara=tenho o Rei de trunfo
sra=não tenho o Rei de trunfo
ada=tenho a Dama de trunfo (ou a dama de trunfo ou um décimo trunfo)
sda=não tenho a Dama de trunfo
asmc=esta voz mostra 2 Ases da mesma cor (vermelhos ou pretos)
asmr=esta voz mostra 2 Ases do mesmo rank (ricos ou pobres)
amm=esta voz mostra 2 Ases misturados (Espadas/Ouros ou Copas/Paus)
chicane=uma chicana
chicane(p1)=uma chicana a %p1%
ascoul(p1)=esta voz mostra o Ás de %p1%
roicoul(p1)=esta voz mostra o Rei de %p1%
asmaj=esta voz mostra o Ás de Copas ou o Ás de Espadas
ctrl=um controle no naipe marcado (Ás, rei, singleton ou chicana), implica forçosamente um fit noutro naipe. Os controles anunciam-se economicamente ("up the line").
ctrl(p1)=um controle a %p1% (Ás, rei, singleton ou chicana), implica forçosamente um fit noutro naipe. Os controles anunciam-se economicamente ("up the line").
ttctrl=um controle (Ás, rei, singleton ou chicana) em todos os naipes exceto trunfo
ctrlun=um controle de primeira no naipe marcado (Ás ou chicana)
ctrlsaut=controle (Ás, rei, singleton ou chicana) no naipe marcado e falta de controle (nem Ás, nem rei, nem singleton, nem chicana) no naipe saltado
ctrlsautatout=ou um jogo mínimo, ou falta de controle (nem Ás, nem rei, nem singleton nem chicana) no naipe saltado
pbctrl(p1)=um problema de controle a %p1% (nem Ás, nem rei, nem singleton nem chicana)
15-17=15-17
0-7=0-7
16-40=16+
stop = voz de paragem porque faltam dois Ases (ou chaves), pede ao parceiro para marcar 5ST
entame3sa = esta voz é um dobre de saída : indica que os adversários provavelmente cabidam se o parceiro fizer uma saída especial : em geral, um naipe rico
bwrois5clef = com exceção do rei de trunfo

[points]
_pointNoIndication=Nenhuma indicação de força
_pointExact(p1)=Exatamente %p1% pon