0-8 = 0-8
9-11 = 9-11
bw5clef(p1) = dieses Gebot ist RKCB mit %p1% als Trumpf: es fragt den Partner, wie viele Schlüsselkarten mit %p1% als Trumpf er hat. Die 5 Schlüsselkarten sind die 4 Asse und der Trumpfkönig (%p1% König).

[forcing]
forcing10=Reizen "nicht forcing"
forcing11="Forcing" Gebot
forcing12=Gebot "Game forcing"
forcing13=Reizen "Pass forcing"
forcing20=Reizen "nicht forcing"
forcing21="Forcing" Gebot
forcing22=Reizen "game forcing"
forcing23=Reizen "Pass forcing"


[General]
&=und
|=oder
T=Treff
K=Karo
C=Coeur
P=Pik
nat=Dieses Gebot ist natürlich
exactcoul(p1,p2)=genau %p1% Karten bei %p2%
coul(p1,p2)=mindestens %p1% Karten bei %p2%
sanscoul(p1,p2)=diese Reizung verneint %p1% Karten bei %p2%
courte(p1)=Kürze in %p1% (Singleton oder Chicane)
singleton(p1)=ein Singleton bei %p1%
irreg=ein unregelmässige Hand
reg=eine regelmässige Hand
arret=ein Stop in der gegnerischen Farbe (ein As, mindestens ein König zu Zweit, die Dame zu Dritt oder der Bube zu Viert)
arret(p1)=ein Stop bei %p1%
pb=ein Stopper-Problem in der angezeigten Farbe, um 3NT zu spielen. Der Partner bietet 3NT mit Stärke in der Farbe.
pb(p1)=ein Stopper-Problem bei %p1%
force(p1)=Stärke in %p1%, dh. ein Honneur oder eine Anzahl Honneurs
ouvsa=im Prinzip eine regelässige Hand ohne 5er Oberfarbe
sa=eine eher ausgeglichene Hand ohne 4er Oberfarbe, die auf 1er Stufe hätte angezeigt werden können
tolerance(p1)=ein Spiel für %p1%
pref=eine Präferenz für die erwähnte Farbe
pref(p1)=eine Präferenz für %p1%
paspref=eine Hand ohne Präferenz der Farbe des Partners
fit(p1)=Ein Fit in %p1%
fit=ein Fit
fitjump=eine Länge in der angesagten Farbe (ausnahmsweise eine Stärke) und daher ein Fit in der Farbe des Partners
sansfit=diese Reizung verneint einen Fit
bic(p1,p2)=ein Zweifärber mit %p1%/%p2%
bicdeuxautres=ein Zweifärber in den zwei noch nicht angesagten Farben
bicinde=ein Zweifärber mit der anderen Oberfarbe und einer unbestimmten Unterfarbe
bicpolish=ein unbestimmter Zweifärber mit mindestens einer Oberfarbe
bicsixquatre=ein Zweifärber mit zwei nicht angesagten Farben, sechs Karten in der billigeren Farbe und 4 Karten in der höheren Farbe
maj(p1)=%p1% Karten in der Oberfarbe
tricolore=eine Dreifärber Hand, dh. mindestens drei Farben mit 4 Karten
mauvaisatouts=schlechte Trumpf-Qualität
belle(p1,p2)=%p1% schöne Karten in %p2%
barrage=eine Voranzeige in der genannten Farbe, dh. eine schwache Hand in Punkten mit einer langen Farbe
canap=ein Canapé, dh. die zweite Farbe ist länger als die erste Farbe
faible=eine schwache Hand
fort=eine starke Hand
competitif=ein konkurrenzfähige Reizung, um den Gegner den Kontrakt nicht spielen zu lassen. Achtung: es handelt sich hier nicht darum, ein Vollspiel zu erfüllen.
limite=eine Hand mit dem Vorschlag, ein Vollspiel nur mit einem zusätzlichen Punkt zu spielen.
essaimanche=eine Hand mit der Hoffnung auf ein Vollspiel
manche=eine Hand, um ein Vollspiel zu spielen, ohne Hoffnung auf einen Schlemm
chelem=Hoffnung auf einen Schlemm
choixchelem=die Stärke, einen Schlemm zu spielen und die Suche nach dem besten Trumpf
maxi=eine Hand mit Maximum
mini=eine Hand mit Minimum
cher=ein starker Zweifärber (dh. man kann nicht auf 2er Stufe zur ersten genannten Farbe des Eröffners zurück kehren)
eco=ein billiger Zweifärber: eine neue Farbe nennen, die niedriger ist als die eröffnete Farbe, ohne Sprung
saut=ein Zweifärber mit Sprung (dh. man hätte die 2. Farbe bereits auf niedrigerer Stufe nennen können)
quantitatif=eine Einladung, den Slam zu spielen, falls der Partner keine Minimumhand hat.
dujeu=eine Reserve an Punkten ohne zusätzliche Einzelheiten
dujeu(p1)=Das Gebot zeigt Extrastärke, mindestens %p1% Punkte, gibt aber keine zusätzliche Auskunft über die Verteilung.
f=dies ist eine forcierende Reizung, dh. der Partner kann nicht passen, wenn er an der Reihe ist zu bieten
nf=dies ist eine nicht-forcierende Reizung, dh. der Partner kann passen, wenn er an der Reihe ist zu bieten
fp=dies ist ein Sign-off (oder Abschluss), d.h der Partner muss passen, wenn er an der Reihe ist zu bieten
fm=diese Reizung ist spielforcierend, dh. der Partner kann nicht passen solange kein Vollspiel erreicht ist
appel=Informationskontra : verspricht Unterstützung in den vom Gegner nicht gereizten Farben.
entame=diese Reizung verlangt vom Partner diese Farbe auszuspielen, wenn der Gegner die Stiche gewinnt und der Eröffnungsstich an ihn geht
lightner=diese Reizung verlangt vom Partner eine spezielle Ansage: im Allgemeinen bietet man die erste Farbe des Dummys oder sucht eine Chicane
entamesa=diese Reizung ist eine Kontraansage: man glaubt, dass man den Gegner zu Fall bringt, wenn der Partner eine spezielle Ansage macht: im Allgemeinen handelt es sich um die erste Farbe, angesagt vom Dummy
pun=es handelt sich um eine Strafreizung, dh. Sie zeigt an, dass man den Gegner zu Fall bringen kann
pundsune=diese Reizung zeigt die Absicht, in mindestens einer der verbliebenen Farben ein Strafreizung zu generieren
sos=diese Reizung zeigt die Absicht, zu einer anderen Trumpffarbe zu wechseln, indem man den Partner bittet, seine längste Farbe anzuzeigen
surcontre=diese Reizung bedeutet, dass man denkt, den kontrierten Kontrakt zu gewinnen und daher vorschlägt, dass der Partner nach dem Re-Kontra passt
ambigu=dies ist ein Verzögerungsreizung ohne spezielle Bedeutung
cuebid=es handelt sich um ein Cue-Bid. Indem man die Farbe des Gegners nennt, zeigt man eine starke Hand oder eine Hand ohne natürliche verfügbare Ansage. Gelegentlich zeigt es einen Stopper in dieser Farbe, um NT zu spielen.
cuebidfit=es handelt sich um ein Cue-Bid und zeigt einen Fit in einer starken Hand an
relais=es handelt sich um ein Relay, eine Art abwartende Reizung
sansinfo=dies ist eine unerwartete Reizung und zeigt keine weiteren Informationen an
ras=diese Reizung zeigt nichts Spezielles an
pourjouer=diese Reizung zeigt den Kontrakt an, der anhand der gegebenen Informationen am besten zu spielen ist.
obligatoire=es handelt sich um eine obligatorische Korrektur
interdit=diese Reizung ist strikt verboten
bug=BUG: bitte dieses Problem melden
reveil=dies ist eine Reveilansage, dh. sie wird nach zweimaligem Passen genannt. Sie kann mit einer schwächeren Hand angesagt werden, denn falls der Spieler passt, wird das Reizen hier angehalten.
poc=diese Reizung bittet den Partner zu passen, falls es sich um seine Farbe handelt oder in seiner Farbe zu korrigieren
demandemin=diese Reizung bittet den Partner seine Unterfarbe zu nennen
demandemaj=diese Reizung bittet den Partner seine Oberfarbe zu nennen
majcinq=Eröffnungssystem 5er Oberfarbe, dh. die Eröffnung einer Oberfarbe verspricht mindestens 5 Karten in der Farbe
polish=Polnisches System
mm=Bessere Unterfarbe (man eröffnet die längere Unterfarbe. Bei gleicher Länge öffnet man 1 Karo, außer mit 3 Treff- und 3 Karokarten: dann eröffnet man 1 Treff)
multi=dies ist eine künstliche Ansage, sie zeigt eine schwache Hand, entweder in Coeur oder Pik
deuxpolo=diese Reizung zeigt eine schwache Hand mit 5 Karten in der angesagten Oberfarbe und einer unbestimmten 5er Unterfarbe
deuxpolomaj=diese Reizung zeigt einen Zweifärber in Coeur und einer anderen unbestimmten Farbe an
kquatre=Eröffnungssystem 4er Karo, d.h. das Gebot von 1 Karo verspricht mindestens 4 Karten
drury=dieses Gebot ist künstlich und wird Drury genannt. Es zeigt Maximum der gepassten Hand mit einem Fit in der eröffneten Farbe.
troisf=es handelt sich um die 3. Farbe forcing und zeigt entweder ein Stopperproblem in der 4. Farbe an, oder ist auf der Suche nach einem Fit mit einer starken Hand, um die Sequenz vor dem Fit als forcierend zu deklarieren
troisfdeuxsurun=es handelt sich um die 3. Farbe forcing und zeigt entweder ein natürliches Reizen oder eine Stärke mit einem Stopperproblem in der 4. Farbe an
quatriemef=es handelt sich um die 4. Farbe forcing an und zeigt entweder ein Stopperproblem in der angesagten Farbe an, oder ist auf der Suche nach einem Fit mit einer starken Hand, um die Sequenz vor dem Fit als forcierend zu deklarieren
spoutnik=es handelt sich um eine künstliche Ansage und heisst Spoutnik. Sie zeigt ca. 8 Punkte an, offen nach oben und verspricht mindestens vier Karten in einer noch nicht angesagten Farbe
fortinde=diese Reizung zeigt eine starke Hand in einer unbestimmten Farbe oder eine regelmässige Hand mit 22-23 Punkten an
gambling=diese Reizung zeigt eine 7er Unterfarbe an (z.B. AKD)
landy=es handelt sich um eine künstliche Ansage mit Namen Landy. Es zeigt einen Zweifärber mit den beiden Oberfarben und mindestens 4 Karten.
deuxsafit=ein Fit in einer einladenden Hand mit 3 Trümpfen oder eine ausgeglichene Hand mit 12-14 Punkten
splinter=es handelt sich um eine künstliche Ansage genannt Splinter. Es zeigt eine Kürze in der genannten Farbe und einen starken Fit in der letzt genannten Farbe des Partners
roudi=es handelt sich um eine künstliche Ansage, die Roudi Konvention. Es zeigt mindestens eine spieleinladende Hand und fragt den Partner, ob er 3 Karten in dieser Farbe hält.
leben=es handelt sich um eine künstliche Ansage, die Lebensohl Konvention. 2NT zeigt eine schwache Hand. Andere Ansagen zeigen eine starke Hand.
truscott=dies ist ein künstliches Gebot. Es handelt sich um die Truscott Konvention. 2NT zeigt eine mindestens einladende Hand mit einem Fit, die Hebung auf die 3er Stufe würde eine schwache Hand zeigen.
moderateur=es handelt sich um eine künstliche Ansage, die verschlüsselte 2NT Konvention. Sie zeigt allgemein eine schwache Hand und bittet den Partner, seine längste Farbe mit einer minimalen Hand zu zeigen.
josephine=dies ist eine herkömmliche Ansage, die Josephine (Grand Slam Stärke) Konvention. Der Partner bittet um einen Grand Slam wenn er die zwei hohen Honeurs in der Trumpffarbe hält. Man kann auch 6T antworten, mit Ass oder König in Trumpf und einer zusätzlichen Trumpfkarte.
josephine6T=dies ist eine herkömmliche Antwort, die Josephine (Grand Slam Stärke) Konvention. Sie zeigt Trumpf As oder König und eine zusätzliche Trumpfkarte.
stayman=dies ist eine herkömmliche Ansage, die Stayman Konvention. Der Partner fragt, ob man eine 4er Oberfarbe hält. Dies ist mindestens einladend zum Vollspiel und zeigt mindestens eine 4er-Oberfarbe.
staymanrep=diese Ansage zeigt, dass man weder 4 Karten in Coeur, noch 4 Karten in Pik hält.
texas(p1)=es handelt sich um eine künstliche Ansage, den Jacoby Transfer. Es zeigt eine Länge in %p1% ohne Angabe der Stärke
transfert(p1)=es handelt sich um einen Transfer und bittet um Angabe von der %p1% Farbe, um in der starken Hand zu spielen. Man entscheidet sich für den Trumpf in %p1%.
bw=es handelt sich um die Blackwood-Ansage. Man will vom Partner wissen, wieviele Asse er hält.
bwrois=diese Blackwood Ansage fragt nach den Königen. Man will vom Partner wissen, wie viele Könige er hält
bw(p1)=es handelt sich um die Blackwood-Ansage (Frage nach der Anzahl Assen) mit %p1% Trumpfass
bwda=diese Reizung bittet den Partner anzugeben, ob er die Trumpfkönigin hält
as(p1,p2)=diese Ansage zeigt %p1% oder %p2% Asse
roi(p1,p2)=diese Ansage zeigt %p1% oder %p2% Könige
clef(p1,p2)=diese Ansage zeigt %p1% oder %p2% Schlüsselkarten. Die 5 Schlüsselkarten sind 5 Asse und der Trumpfkönig.
as(p1)=diese Ansage zeigt %p1% Asse
clef(p1)=diese Ansage zeigt %p1% Schlüsselkarten. Die 5 Schlüsselkarten sind die 4 Asse und der Trumpfkönig.
roi(p1)=diese Ansage zeigt %p1% Könige
ara=ich halte den Trumpfkönig
sra=ich halte den Trumpfkönig nicht
ada=Ich halte die Trumpfdame (entweder die Trumpfdame oder eine zehnte Trumpfkarte)
sda=ich halte die Trumpfdame nicht
asmc=die Ansage zeigt 2 Asse der selben Farbe (rot oder schwarz)
asmr=die Ansage zeigt 2 Asse der selben Kategorie (Unterfarbe oder Oberfarbe)
amm=die Ansage zeigt 2 gemischte Asse (weder der selben Farbe, noch der selben Kategorie)
chicane=eine Chicane
chicane(p1)=eine Chicane in %p1%
ascoul(p1)=diese Ansage zeigt das Ass von %p1%
roicoul(p1)=diese Ansage zeigt den König von %p1%
asmaj=diese Ansage zeigt das Ass in Coeur oder das Ass in Pik
ctrl=eine Kontrolle in der genannten Farbe (Ass, König, Singleton oder Chicane) Es zeigt einen Fit in einer anderen Farbe an. Kontrollen werden ökonomisch genannt.
ctrl(p1)=eine Kontrolle in %p1% (As, König, Singleton oder Chicane) zeigt an, dass man einen fit in einer anderen Farbe hat. Die Kontrollen werden in einer ökonomischen Art angezeigt.
ttctrl=eine Kontrolle in allen anderen Farben als Trumpf (As, König, Singleton oder Chicane)
ctrlun=eine Kontrolle in der angesagten Farbe (As oder Chicane)
ctrlsaut=Kontrolle in der angesagten Farbe (As, König, Singleton oder Chicane) und man kontrolliert nicht (weder Ass, noch König, noch Chicane) in der ausgelassenen Farbe
ctrlsautatout=entweder eine Minimumhand oder eine Hand ohne Kontrolle (As, König, Singleton oder Chicane) in der ausgelassenen Farbe
pbctrl(p1)=eine Kontrolle in %p1% (weder Ass, noch König, noch Singleton, noch Chicane)
15-17=15-17
0-7=0-7
16-40=16+
stop = ansage mit zwei fehlenden Assen (oder Schlüsselkarten). Hinweis an den Partner, 5NT zu reizen
entame3sa = diese Reizung ist eine Kontraansage: sie deutet darauf hin, dass man meint die Gegner zu Fall zu bringen, wenn der Partner eine besondere Ansage macht: In aller Regel handelt es sich um eine ranghöhere Farbe
bwrois5clef = außer dem Trumpfkönig

[points]
_pointNoIndication=Keine Angaben zur Punktzahl
_pointExact(p1)=Genau %p1% Punkte
_pointBetween(p1,p2)=Zwischen %p1% und %p2% Punkten
_pointAlLeast(p1)=Mindestens %p1% Punkte
_pointAtMost(p1)=Höchstens %p1% Punkte


[color]
_colorNoIndication=Keine Angabe
_colorExact(p1)=Genau %p1% Karten
_colorBetween(p1,p2)=Zwischen %p1% und %p2% Karten
_colorAlLeast(p1)=Mindestens %p1% Karten
_colorAtMost(p1)=Höchstens %p1% Karten

