0-8 = 0-8
9-11 = 9-11
bw5clef(p1) = dette er en RKCB-melding med %p1% som trumf: spørger makker, hvor mange nøglekort med %p1% som trumf han har. De 5 nøglekort er de 4 esser og trumfkonge (%p1% konge).

[forcing]
forcing10=Ikke "kravmelding"
forcing11="Kravmelding"
forcing12="Udgangskrav"
forcing13="Kravpas"
forcing20=Ikke "kravmelding"
forcing21="Kravmelding"
forcing22="Udgangskrav"
forcing23="Kravpas"


[General]
&=og
|=eller
T=Klør
K=Ruder
C=Hjerter
P=Spar
nat=det er en naturlig melding
exactcoul(p1,p2)=præcis %p1% kort i %p2%
coul(p1,p2)=mindst %p1% kort i %p2%
sanscoul(p1,p2)=dette bud benægter %p1% kort i %p2%
courte(p1)=korthed i %p1% (en singleton eller renonce)
singleton(p1)=en singleton in %p1%
irreg=en ubalanceret hånd
reg=en balanceret hånd
arret=en stopper i modstanderens farve (esset, kongen anden, damen mindst tredje eller knægten mindst fjerde)
arret(p1)=en stopper in %p1%
pb=et problem med en stopper i den meldte farve i tilfælde af en 3UT-melding. Makker melder 3UT med styrke i farven.
pb(p1)=et problem med en stopper i %p1%
force(p1)=styrke i %p1%, dvs en honnør eller flere
ouvsa=en balanceret hånd og som regel uden 5-farve i major
sa=en temmelig balanceret hånd uden en 4-farve i major, som meldes på 1-trinnet
tolerance(p1)=en accept af %p1%
pref=en præference til den meldte farve
pref(p1)=en præference til %p1%
paspref=en hånd uden nogen præference til makkers farver
fit(p1)=en tilpasning i %p1%
fit=en tilpasning
fitjump=længde i den meldte farve (undtagelsesvis styrke) lige som der også er tilpasning i makkers farve
sansfit=meldingen benægter tilpasning
bic(p1,p2)=en 2-farvet hånd med %p1%/%p2%
bicdeuxautres=en 2-farvet hånd med 2 ubekendte farver
bicinde=en 2-farvet hånd med den anden major og en ukendt minor
bicpolish=en ubekendt 2-farvet hånd med mindst en major
bicsixquatre=en ubekendt 2-farvet hånd med 6 kort i den laveste farve og 4 i den højeste
maj(p1)=%p1% kort i major
tricolore=en 3-farvet hånd dvs. mindst 3 4-farver
mauvaisatouts=Dårlig trumfkvalitet
belle(p1,p2)=%p1% gode kort i %p2%
barrage=en spææring i den meldte farve dvs. en pointsmæssig svag hånd med en lang farve
canap=en canapé dvs. at den anden farve er længere end den første
faible=en svag hånd
fort=en stærk hånd
competitif=en konkurrerende melding for at forhindre modstanderne i at få kontrakten. Giv agt! Det er ikke rundekrav.
limite=en inviterende hånd dvs. der skal kun meldes udgang med lidt ekstra points.
essaimanche=en der giver forhåbninger om at spille en udgang
manche=en hånd der udelukker slem
chelem=forventninger om en slem
choixchelem=styrke til at spille en slem og søger efter den bedste trumf
maxi=en maksimumshånd
mini=en minimumshånd
cher=en stærk 2-farvet hånd (dvs. du kan ikke gå tilbage til åbners første farve på 2-trinnet)
eco=en meldeøkonomisk 2-farvet hånd: at melde en ny farve, der er lavere end åbningsfarven, uden at springe
saut=et spring med en 2-farvet hånd (dvs. du kunne have meldt farven på et lavere trin)
quantitatif=en slem-invitation hvis makker ikke har minimum
dujeu=lidt ekstra points uden at præcisere
dujeu(p1)=Denne melding viser lidt ekstra points - mindst %p1% points, men uden yderligere beskrivelse af fordelingen.
f=dette er rundekrav dvs. at makker ikke kan passe næste gang han skal melde
nf=dette er ikke en kravmelding dvs. makker kan passe næste gang han skal melde
fp=dette er en stopmelding dvs. makker skal passe næste gang det er hans tur til at melde
fm=denne melding er rundekrav dvs. makker må ikke passe før udgang er nået
appel=dette er en oplysningsdobling: den viser støtte i modstandernes umeldte farver
entame=dette beder makker om at spille ud i denne farve hvis modstanderne får kontrakten og makker skal spille ud
lightner=dette er en Lightner-dobling: makker beder om et specielt udspil, hvilket normalt er bordets først meldte farve eller måske en renonce
entamesa=dette er en udspilsdirigerende dobling: den viser, at du tror I kan sætte kontrakten, hvis makker kommer med et specielt udspil, hvilket normalt er bordets først meldte farve
pun=dette er straf dvs. den viser, at du tror I kan sætte kontrakten
pundsune=denne melding viser hensigten at strafdoble mindst en af de resterende farver
sos=denne melding har til formål at flygte til en anden trumffarve, og beder makker om at melde en lang farve
surcontre=denne melding betyder, at du tror du kan vinde den doblede kontrakt og foreslår derfor makker at passe redoblingen.
ambigu=dette er en afventende melding uden speciel betydning
cuebid=dette er et cue-bid. Den består i at melde modstandernes farve og viser enten en stærk hånd eller en hånd uden en naturlig melding til rådighed. Somme tider viser den en stopper i farven for at kunne spille UT.
cuebidfit=denne melding er et cue-bid. Den består i at melde modstanderens farve. Her viser den tilpasning og en stærk hånd.
relais=dette er en relæ-melding dvs. en afventende melding
sansinfo=dette er en uventet melding, og den giver derfor ingen nye informationer
ras=denne melding viser ikke noget specielt
pourjouer=denne melding viser den kontrakt der ser ud til at være den bedste ifølge meldeforløbet.
obligatoire=denne melding er påtvunget rettelse
interdit=denne melding er strengt forbudt
bug=BUG: rapporter venligst dette problem
reveil=dette er en genåbning dvs sige meldingen kommer efter 2 passer. Den kan meldes med svagere hænder for hvis spilleren passer stopper meldingerne her.
poc=denne melding beder makker om at passe, hvis jeg meldte hans farve og ellers korrigerer han til sin farve
demandemin=denne melding beder makker om at melde sin minor
demandemaj=denne melding beder makker om at melde sin major
majcinq=åbningssystem med 5-farver i major dvs. man lover mindst 5 kort i den meldte major
polish=Polish Club bid
mm=Bedste minor (Du åbner med den bedste minor-farve og med lige stor længde åbner du med 1 ruder - undtagen med 3 klør og 3 ruder. I så fald åbner du med 1 klør.)
multi=dette er en kunstig melding visende en svag hånd i enten hjerter eller spar
deuxpolo=denne melding viser en svag hånd med 5 kort i den meldte major og 5 kort i en ukendt minor
deuxpolomaj=denne melding viser en 2-farvet hånd med hjerter og en ukendt farve
kquatre=4-farve ruder-åbningssystem dvs. meldingen 1 ruder lover mindst 4-farve
drury=dette er en kunstig melding kaldt Drury. Den viser en maksimumshånd, der har forhåndspasset, med tilpasning i åbningsfarven.
troisf=denne kravmelding i 3. farve viser enten et problem med en stopper i 4. farve eller søger tilpasning med en stærk hånd med udgang for øje.
troisfdeuxsurun=denne melding er kravmelding i 3.farve dvs. enten er den naturlig eller den viser styrke med et "stopperproblem" i 4. farve
quatriemef=denne kravmelding i 4. farve viser et "stopperproblem" i den meldte farve eller søger tilpasning med en stærk hånd inden det videre meldeforløb
spoutnik=dette er en kunstig melding kaldet Sputnik. Den viser minimum 8+ og mindst 4 kort i en farve som ikke er blevet meldt endnu.
fortinde=denne melding viser en stærk hånd men farven er ukendt eller en balanceret hånd med 22-23hp
gambling=denne melding viser en god 7-farve i minor (med EKD)
landy=dette er en kunstig melding kaldt Landy. Den viser en 2-farvet hånd med de 2 majorfarver med mindst 4 kort.
deuxsafit=en tilpasning på en inviterende hånd med 3 trumfer eller en balanceret hånd med 12-14hp
splinter=dette er en kunstig melding kaldt Splinter. Den viser korthed i den meldte farve og god tilpasning i makkers sidstmeldte farve.
roudi=dette er en kunstig melding. Den hedder Roudi-konventionen. Den viser mindst en udgangsinviterende hånd og spørger makker om han har 3 kort i din farve.
leben=dette er en kunstig melding. Den hedder Lebensohl. 2UT viser en svag hånd. Andre meldinger viser en stærk hånd.
truscott=dette er en kunstig melding. Det er Truscott-konventionen. 2UT viser mindst en inviterende hånd med tilpasning og visning af tilpasningen på 3-trinnet viser en svag hånd.
moderateur=det er en kunstig melding. Det er en svag 2UT. Den viser som regel en svag hånd beder makker om at melde sin længste farve igen med en minimumshånd.
josephine=det er en konventionel melding. Det er Josephine-konventionen (storeslemkrav efter Josephine Culbertson). Makker bedes melde storeslem, hvis han har 2 store honnører i trumffarven. Man kan også melde 6 klør med es eller konge og en ekstra trumf.
josephine6T=det er et konventionelt svar. Det er Josephine-konventionen (storeslemkrav efter Josephine Culbertson). Det viser es eller konge i trumf og en ekstra trumf.
stayman=det er en konventionel melding. Det er Stayman. Man spørger makker om han har 4 kort i en major. Den garanterer mindst styrke til at invitere til udgang og mindst præcis en 4-farve i major.
staymanrep=meldingen betyder at du hverken har 4 kort hjerter eller 4 kort i spar.
texas(p1)=det er en kunstig melding. Det er Jacoby. Den viser længde i  %p1% uden at fortælle om styrke.
transfert(p1)=det er en transfer som beder åbner melde %p1% for at spille på den gode hånd. Den fastsætter farven %p1% som trumf.
bw=det er Blackwood. Man spørger makker, hvor mange esser han har.
bwrois=det er Blackwood, som spørger efter konger. Makker bliver spurgt, hvor mange konger han har.
bw(p1)=det er Blackwood (hvor mange esser har du?) med %p1% som trumf
bwda=den melding spørger makker om han har trumf dame
as(p1,p2)=meldingen viser %p1% eller %p2% es(ser)
roi(p1,p2)=denne melding viser %p1% eller %p2% konge(r)
clef(p1,p2)=meldingen viser %p1% eller %p2% nøglekort. De 5 kort er 4 esser og trumf konge.
as(p1)=meldingen viser %p1% es(ser)
clef(p1)=meldingen viser %p1% nøglekort. De 5 kort er 4 esser og trumf konge.
roi(p1)=meldingen biser %p1% konge(r)
ara=Jeg har trumf konge
sra=Jeg har ikke trumf konge
ada=Jeg har trumf dame (enten trumf dame eller en tiende trumf)
sda=Jeg har ikke trumf dame
asmc=meldingen viser 2 esser i samme farve (røde eller sorte)
asmr=meldingen viser 2 esser i farver med samme meldeværdi (minor eller major)
amm=meldingen viser 2 "blandede" esser (hverken samme farve eller meldeværdi)
chicane=en renonce
chicane(p1)=en renonce i %p1%
ascoul(p1)=meldingen viser %p1% es
roicoul(p1)=meldingen viser %p1% konge
asmaj=meldingen viser hjerter es eller spar es
ctrl=en kontrol i den meldte farve (esset, kongen, en singleton eller en renonce). Det betyder nødvendigvis tilpasning i en anden farve. Kontrollerne meldes billigst muligt.
ctrl(p1)=en kontrol i %p1% (esset, kongen, en singleton eller en renonce). Det betyder nødvendigvis tilpasning i en anden farve. Kontrollerne meldes billigst muligt.
ttctrl=en kontrol i alle andre farver end trumf (esset, kongen, en singleton eller en renonce)
ctrlun=en førstekontrol i den meldte farve (esset eller en renonce)
ctrlsaut=kontrol i den meldte farve (esset, kongen, en singleton eller en renonce) og ingen kontrol i den farve man sprang over (hverken es eller konge eller singleton eller renonce)
ctrlsautatout=enten en minimumshånd eller manglende kontrol i den oversprungne farve (hverken es eller konge eller singleton eller renonce)
pbctrl(p1)=et problem med kontroller i %p1% (hverken es eller konge eller singleton eller renonce)
15-17=15-17
0-7=0-7
16-40=16+
stop = afmelding fordi man mangler 2 esser (eller nøglekort) - beder makker om at melde 5UT
entame3sa = dette er en udspilsdirigerende dobling: den viser, at du tror, I kan sætte kontrakten, hvis makker kommer med et specielt udspil, hvilket oftest vil være i en af majorfarverne
bwrois5clef = ud over trumfkonge

[points]
_pointNoIndication=Ingen pointsvisning
_pointExact(p1)=Nøjagtig %p1% points
_pointBetween(p1,p2)=Mellem %p1% og %p2% points
_pointAlLeast(p1)=Mindst %p1% points
_pointAtMost(p1)=højst %p1% points


[color]
_colorNoIndication=Ingen visning
_colorExact(p1)=Præcis %p1% kort
_colorBetween(p1,p2)=Mellem %p1% og %p2% kort
_colorAlLeast(p1)=Mindst %p1% kort
_colorAtMost(p1)=Højst %p1% kort

