0-8 = 0-8
9-11 = 9-11
bw5clef(p1) = dit bod is RKC Blackwood met %p1% als troef: het vraagt partner naar het aantal sleutelkaarten met %p1% als troef. De vijf sleutelkaarten zijn de vier azen en troefheer (%p1% heer).

[forcing]
forcing10=Bieding "Niet forcing"
forcing11=Bieding "Forcing"
forcing12=Bieding "Mancheforcing"
forcing13=Bieding "Forceert tot pass"
forcing20=Bieding "Niet forcing"
forcing21=Bieding "Forcing"
forcing22=Bieding "Mancheforcing"
forcing23=Bieding "Forceert tot pass"


[General]
&=en
|=of
T=Klaveren
K=Ruiten
C=Harten
P=Schoppen
nat=een lange genoemde kleur
exactcoul(p1,p2)=%p1% %p2% kaarten
coul(p1,p2)=minstens %p1% %p2% kaarten
sanscoul(p1,p2)=deze bieding ontkent %p1% %p2% kaarten
courte(p1)=a %p1% een korte kleur (een singleton of een renonce)
singleton(p1)=een singleton %p1%
irreg=een ongebalanceerde hand
reg=een gebalanceerde hand
arret=een stopper in de kleur van de tegenpartij (Aas, koning met ten minste één kleintje, vrouw ten minste met twee kleintjes of boer ten minste met drie kleintjes)
arret(p1)=een stop in %p1%
pb=een stop probleem in de genoemde kleur. De partner biedt 3NT met kracht in die kleur.
pb(p1)=een stop probleem in %p1%
force(p1)=een %p1% kracht, dat wil zeggen een honneur of een groepje honneurs
ouvsa=een gebalanceerde hand, in principe zonder vijfkaart hoog
sa=een nogal gebalanceerde hand die niet op 1-niveau een vierkaart hoog kan bieden
tolerance(p1)=verdraagt %p1%
pref=voorkeur voor de genoemde kleur
pref(p1)=voorkeur voor %p1%
paspref=een hand zonder voorkeur voor de kleuren van partner
fit(p1)=fit in %p1%
fit=fit
fitjump=lengte in de genoemde kleur (bij voorkeur een goede kleur) en fit in de kleur van partner
sansfit=deze bieding ontkent fit
bic(p1,p2)=een tweekleurenspel %p1%/%p2%
bicdeuxautres=een tweekleurenspel in de twee ongenoemde kleuren
bicinde=een tweekleurenspel met de andere ongeboden hoge kleur en een onbekende lage kleur
bicpolish=een onbekend tweekleurenspel met ten minste één hoge kleur
bicsixquatre=een tweekleurenspel met twee onbekende kleuren, een zeskaart in de lagere kleur en een vierkaart in de hogere kleur
maj(p1)=%p1% kaarten in de hoge kleuren
tricolore=een driekleurenspel, dat wil zeggen ten minste drie vierkaarten
mauvaisatouts=een slechte hand voor een troefcontract
belle(p1,p2)=%p1% mooie %p2% kaarten
barrage=een preëmpt in de genoemde kleur, dat wil zeggen een zwakke hand met een mooie lange kleur
canap=een 'canapé', waarbij de tweede kleur langer is dan de eerste
faible=een zwakke hand
fort=een sterke hand
competitif=geen manchepoging, het is slechts een competitieve bieding gericht op het voorkomen dat de tegenstander speelt.
limite=een invite, dat wil zeggen dat de partner geacht wordt om alleen de manche te bieden als hij overwaarde heeft
essaimanche=een manchepoging
manche=genoeg kracht om de manche te spelen maar geen sleminteresse
chelem=een slempoging
choixchelem=genoeg kracht om een slem te spelen en de beste troefkleur te zoeken
maxi=een maximum
mini=een minimum
cher=een sterk tweekleurenspel, dat wil zeggen dat we niet op 2-niveau in de eerste kleur van de openaar kunnen spelen
eco=een middelmatig tweekleurenspel: een nieuwe kleur die lager is dan de eerste kleur wordt zonder sprong genoemd
saut=een sprong naar een tweede kleur, dat wil zeggen dat het mogelijk was geweest de tweede kleur op een lager niveau te bieden
quantitatif=een voorstel tot het spelen van slem als de partner niet minimaal is
dujeu=overwaarde die niet nader te omschrijven is
dujeu(p1)=Deze bieding toont overwaarde, ten minste %p1% punten maar geeft geen verdere informatie over de verdeling
f=forcing, partner moet bieden zodra hij aan de beurt komt
nf=non-forcing, partner mag passen als hij aan de beurt komt
fp=dit bod is bedoeld om af te zwaaien, dat wil zeggen dat partner geacht wordt te passen wanneer deze aan de beurt is
fm=mancheforcing bieding, dat wil zeggen dat partner niet mag passen tot de manche geboden is
appel=dit is een take-out bieding, en toont steun in andere kleuren dan die van de tegenstanders.
entame=deze bieding vraagt de partner in deze kleur uit te komen als de tegenstander moet spelen en hij moet starten
lightner=dit is een lightner doublet, en vraagt de partner om een speciale start: doorgaans is dat de eerste kleur van de dummy of moet hij op zoek naar een renonce.
entamesa=dit is een startdoublet bieding; het geeft aan dat de manche van de tegenstanders down te spelen is met een speciale start: doorgaans de eerste kleur van de dummy
pun=dit is een strafbieding, dat wil zeggen dat we vermoeden dat we het contract down kunnen spelen
pundsune=deze bieding geeft de intentie weer om de tegenstanders in ten minste één van hun kleuren voor straf te doubleren
sos=een bieding die gebruikt wordt om naar een andere speelsoort te ontsnappen, partner moet nu zijn langste kleur bieden
surcontre=dit is een sterk bod. We vertrouwen erop dat we dit contract zullen halen en we vragen partner om te passen
ambigu=dit is een wachtbieding, het betekent niets speciaals
cuebid=dit is een cuebieding, het is de kleur van de tegenpartij en toont of een sterke hand zonder natuurlijke bieding of een stop probleem in deze kleur, zonder stop bij de partner kan er geen sans atout worden gespeeld.
cuebidfit=dit is een cuebieding, het is de kleur van de tegenpartij en toont een fit en een sterke hand.
relais=dit is een relay, een soort wachtbieding
sansinfo=dit is een onverwachte bieding waarover verder niets te zeggen valt
ras=deze bieding belooft niets speciaals
pourjouer=dit contract lijkt beter speelbaar aan de hand van de informatie die uit het bieden naar voren is gekomen
obligatoire=deze bieding is een verplichte correctie
interdit=dit bod is ten strengste verboden
bug=BUG: geef deze bug alstublieft aan ons door
reveil=dit is een balance, dat wil zeggen dat het na twee keer pas wordt gedaan. Het kan zwakker zijn dan normaal omdat het bieden anders afgelopen zou zijn.
poc=converteerbaar, partner moet passen als ik zijn kleur bood en anders zijn kleur bieden
demandemin=deze bieding vraagt partner zijn lage kleur te bieden
demandemaj=deze bieding vraagt partner zijn hoge kleur te bieden
majcinq=vijfkaart hoog systeem, deze opening in een hoge kleur belooft vijf kaarten in de genoemde kleur
polish=volgens een Pools systeem
mm=Better minor (open de langste lage kleur, bij gelijke lengte één ruiten, tenzij klaveren en ruiten allebij een driekaart zijn, dan één klaveren.
multi=dit is een onnatuurlijke bieding, het toont een zwakke hand met hartens of schoppens
deuxpolo=deze bieding toont een zwakke hand met vijf kaarten in de genoemde hoge kleur en een onbekende vijfkaart laag
deuxpolomaj=deze bieding toont een zwakke hand met een tweekleurenspel: hartens en een onbekende kleur
kquatre=systeem waarin de 1R-opening ten minste een vierkaart ruiten belooft
drury=dit is een kunstmatig bod, Drury genaamd, het toont een maximaal voorgepaste hand met fit in de geopende kleur
troisf=dit is de derde kleur forcing en het geeft of een stop probleem in de vierde kleur aan, of we zijn nog op zoek naar een fit, of een sterke hand die eerst forcing biedt voor de fit aan te geven
troisfdeuxsurun=dit is derde kleur forcing: of het is natuurlijk of het toont een stop probleem in de vierde kleur
quatriemef=dit is de vierde kleur forcing en het geeft of een stop probleem in de geboden kleur aan, of we zijn nog op zoek naar een fit, of een sterke hand die eerst forcing biedt voor de fit aan te geven
spoutnik=dit is een onnatuurlijke bieding, een conventie genaamd Spoetnik. Het toont minimaal acht punten, kent geen maximum en het toont ten minste een vierkaart in een ongenoemde kleur.
fortinde=deze bieding toont een sterke hand met een onbekende kleur of 22-23 punten met een gebalanceeerde hand.
gambling=deze bieding toont een zevenkaart in een lage kleur, met ten minste AHV
landy=dit is een onnatuurlijke bieding, een conventie genaamd 'Landy'. Het toont een tweekleurenspel met twee ten minste vierkaarten in de hoge kleuren.
deuxsafit=een fit in de inviterende hand met een driekaart steun of een mancheforcing met 12-14 punten.
splinter=dit is een onnatuurlijke bieding, een conventie genaamd 'Splinter'. Het toont een singleton of renonce in de geboden kleur en een goede fit in de laatstgeboden kleur van partner.
roudi=dit is een onnatuurlijke bieding, een conventie genaamd 'Roudi'. Het toont een inviterende hand en het vraagt partner of hij een driekaart steun heeft in onze kleur.
leben=dit is een onnatuurlijke bieding, een conventie genaamd 'Lebensohl'. 2NT toont een zwakke hand, andere biedingen tonen een sterke hand.
truscott=dit is een kunstmatige bieding, de Truscott-conventie:  2SA toont ten minste een inviterende hand met fit, een sprong naar 3-niveau toont een zwakkere hand
moderateur=dit is een onnatuurlijke bieding, het toont over het algemeen een zwakke hand en het vraagt partner met een minimum zijn langste kleur te herhalen.
josephine=dit bod is een conventie genaamd Josephine: het vraagt de partner groot slem te bieden als hij twee tophonneurs heeft in de troefkleur. De partner mag ook 6 klaveren bieden als hij de troefaas of -heer heeft en nog iets extra.
josephine6T=dit antwoord is conventioneel, onderdeel van de conventie Josephine: het geeft de troefaas of -heer aan nog iets extra.
stayman=dit is een onnatuurlijke bieding, een conventie genaamd 'Stayman'. Het vraagt partner of hij een vierkaart in een hoge kleur heeft, en het toont genoeg punten om op zijn minst te inviteren voor de manche.
staymanrep=deze bieding geeft aan dat de bieder noch een vierkaart harten, noch een vierkaart schoppen heeft.
texas(p1)=dit is een onnatuurlijke bieding, een conventie genaamd 'Texas'. Het toont veel %p1% en een onbekend aantal punten.
transfert(p1)=dit is een transferbieding die vraagt %p1% vanuit de goede hand te spelen. Het stelt %p1% vast als troef.
bw=dit is een blackwood bieding die vraagt hoeveel azen partner heeft.
bwrois=dit is een Blackwood bieding die vraagt hoeveel heren partner heeft.
bw(p1)=dit is een Blackwood bieding die vraagt om azen met %p1% als troefkleur
bwda=deze bieding vraagt de partner of hij troefvrouw heeft
as(p1,p2)=deze bieding toont de aas in %p1% of %p2%
roi(p1,p2)=deze bieding toont de heer in %p1% of %p2%
clef(p1,p2)=deze bieding toont keycards in %p1% of %p2%.
as(p1)=deze bieding toont de aas in %p1%
clef(p1)=deze bieding toont (een) keycard(s) in %p1%.
roi(p1)=deze bieding toont de heer in %p1%
ara=ik heb troefheer
sra=ik heb troefheer niet
ada=Ik heb troefvrouw (troefvrouw of een tiende troef)
sda=ik heb troefvrouw niet
asmc=dit toont twee azen van dezelfde kleur
asmr=dit toont twee azen van dezelfde rang
amm=dit toont twee ongelijke azen
chicane=een nutteloze renonce
chicane(p1)=een renonce %p1%
ascoul(p1)=deze bieding toont de aas van %p1%
roicoul(p1)=deze bieding toont de koning van %p1%
asmaj=deze bieding toont hartenaas of schoppenaas
ctrl=een controle (aas, heer, singleton of renconce) in de genoemde kleur, het impliceert noodzakelijkerwijs een fit in een andere kleur, economisch controles bieden.
ctrl(p1)=een %p1% controle (aas, heer, singleton of renonce), het impliceert noodzakelijkerwijs een fit in een andere kleur, economisch controles bieden.
ttctrl=een controle (aas, heer, singleton of renconce) in alle kleuren behalve troef
ctrlun=eerste controle (aas of renonce) in de geboden kleur
ctrlsaut=een controle (aas, heer, singleton of renonce) in de genoemde kleur, maar niet in de overgeslagen kleur
ctrlsautatout=of een minimum hand of we missen een controle (aas, heer, singleton of renonce) in de overgeslagen kleur
pbctrl(p1)=een gebrek aan controle in %p1% (geen aas, heer, singleton of renonce)
15-17=15-17
0-7=0-7
16-40=16+
stop = deze bieding is bedoeld om af te stoppen, omdat twee azen (of keycards) weg zijn. De partner wordt verzocht 5SA te bieden.
entame3sa = dit is een doublet om een bepaalde start aan te geven; het geeft aan dat de manche van de tegenstanders down te spelen is met een speciale start. Doorgaans is dit een belangrijke kleur.
bwrois5clef = zonder troefheer

[points]
_pointNoIndication=Geen indicatie op de punten
_pointExact(p1)=Precies %p1% punten
_pointBetween(p1,p2)=Tussen de %p1% en %p2% punten
_pointAlLeast(p1)=Minimaal %p1% punten
_pointAtMost(p1)=Ten hoogste %p1% punten


[color]
_colorNoIndication=Geen aanwijzingen
_colorExact(p1)=Precies %p1% kaarten
_colorBetween(p1,p2)=Tussen de %p1% en %p2% kaarten
_colorAlLeast(p1)=Minimaal %p1% kaarten
_colorAtMost(p1)=Ten hoogste %p1% kaarten

