0-8 = 0-8
9-11 = 9-11
bw5clef(p1) = esto es una pregunta de cartas clave (RKCB) y el triunfo es %p1%: pregunta al compañero cuantas cartas clave tiene si el triunfo es %p1%. Las cinco cartas clave son los 4 Ases y el Rey de triunfo (%p1% Rey).

[forcing]
forcing10=Subasta "No forcing"
forcing11=Subasta "Forcing"
forcing12=Subasta "Forcing de manga"
forcing13=Subasta definitiva
forcing20=Subasta "No forcing"
forcing21=Subasta "Forcing"
forcing22=Subasta "Forcing de manga"
forcing23=Subasta definitiva


[General]
&=y
|=o
T=Trébol
K=Diamante
C=Corazón
P=Pica
nat=esta subasta es natural
exactcoul(p1,p2)=exactamente %p1% cartas de %p2%
coul(p1,p2)=al menos %p1% cartas de %p2%
sanscoul(p1,p2)=esta subasta deniega %p1% cartas de %p2%
courte(p1)=una corta de %p1% (un semifallo o un fallo)
singleton(p1)=un semifallo de %p1%
irreg=un juego irregular
reg=un juego regular
arret=una parada del palo contrario (el As, el Rey, por lo menos segundo, la Dama, por lo menos tercera o la Jota, por lo menos cuarta)
arret(p1)=una parada a %p1%
pb=un problema de parada al palo cantado para intentar jugar 3ST, el partner anunciará 3ST con fuerza en el palo.
pb(p1)=un problema de parada a %p1%
force(p1)=una fuerza a %p1%, o sea un honor o una concentración de honores
ouvsa=un juego regular, en principio sin mayor quinto
sa=una juego bastante regular sin mayor cuarto cantable a nivel de 1
tolerance(p1)=una tolerancia para los %p1%
pref=una preferencia por el palo cantado
pref(p1)=una preferencia por los %p1%
paspref=una mano sin preferencia en los palos del partner
fit(p1)=un enchufe con %p1%
fit=un enchufe
fitjump=una larga del palo cantado (excepcionalmente una fuerza) y también un enchufe en el palo del partner
sansfit=esta subasta deniega un enchufe
bic(p1,p2)=un bicolor %p1%/%p2%
bicdeuxautres=un bicolor de los dos palos aún no cantados
bicinde=un bicolor con el otro mayor y un menor indeterminado
bicpolish=un bicolor indeterminado con un mayor por lo menos
bicsixquatre=un bicolor con dos palos no cantados, seis cartas del menos caro y 4 cartas del más caro
maj(p1)=%p1% cartas en mayor
tricolore=una juego tricolor, es decir, con tres palos cuartos al menos
mauvaisatouts=mala calidad de los triunfos
belle(p1,p2)=%p1% buenas cartas en %p2%
barrage=un barrage en el palo cantado, es decir, una mano de pocos puntos y un palo largo
canap=un canapé, es decir, que el segundo palo es más largo que el primero
faible=una mano débil
fort=una mano fuerte
competitif=una subasta competitiva para impedir a los contrincantes que jueguen un contrato; atención: no se trata en ningún caso de un esfuerzo de manga.
limite=una mano invitacional, es decir, que no se va a la manga sin exceso de juego.
essaimanche=una mano con esperanzas de jugar la manga
manche=una mano de manga sin esperanzas de slam
chelem=esperanzas de slam
choixchelem=fuerza para jugar un slam y buscar el mejor triunfo
maxi=máximo una mano
mini=mínimo una mano
cher=un bicolor caro (o sea que no se puede volver al primer palo del abridor a nivel de 2)
eco=un bicolor económico: anuncio sin saldo de un nuevo palo menos caro que el palo de apertura
saut=un bicolor con salto (o sea que se hubiera podido cantar el palo a nivel inferior)
quantitatif=una propuesta de jugar el slam si el partner no va de mínima
dujeu=reserva de puntos sin más indicaciones
dujeu(p1)=Esta subasta indica une reserva de puntos, por lo menos %p1% puntos, pero sin precisar cuál es la distribución.
f=esta subasta es forcing, es decir, que el partner no puede pasar cuando llegue su turno de hablar
nf=esta subasta es no forcing, es decir, que el partner puede pasar cuando llegue su turno de hablar
fp=esta subasta es definitiva, es decir, que el partner debe pasar cuando le toque hablar el próximo turno de subasta
fm=esta subasta es forcing de manga, es decir, que el partner no puede pasar hasta que no se haya llegado a la manga
appel=esta subasta es de saque, indica un apoyo en los palos no cantados por los adversarios
entame=esta subasta pide al partner que salga de este palo si los adversarios ganan las subastas y él tiene que salir
lightner=esta subasta es un doblo lightner: pide al partner una salida especial, por lo general, del primer palo del muerto o que busque un fallo
entamesa=esta subasta un doblo de salida: indica que se piensa hacer caer a los contrincantes el partner hace una salida especial (por lo general, el primer palo del muerto)
pun=esta subasta es de castigo, es decir, que indica que se piensa hacer caer a los contrincantes
pundsune=esta subasta muestra el deseo de castigar por lo menos en uno de los palos restantes
sos=el objetivo de esta subasta es salvarse en otro palo de triunfo; pide al partner que cante un palo largo
surcontre=esta subasta indica que se piensa ganar el contrato doblado, por lo que pide al partner que pase el redoble.
ambigu=esta subasta es una subasta de espera, que no indica nada en particular
cuebid=esta subasta es cuebid, que consiste en cantar el palo de los contrincantes y muestra una mano fuerte o una mano sin subasta natural disponible; de ahí surge a veces un problema de parada en este palo para jugar los sin triunfo
cuebidfit=esta subasta es un cuebid, consiste en cantar el palo de los contrincantes; muestra un enchufe en una mano fuerte
relais=esta subasta es un relé, similar a una subasta de espera
sansinfo=esta subasta no está prevista y no aporta información nueva
ras=esta subasta no indica nada en particular
pourjouer=esta subasta indica el contrato que parece el mejor, en base a la información de la secuencia de subastas.
obligatoire=esta subasta es una rectificación obligatoria
interdit=esta subasta está formalmente prohibida
bug=BUG: agradecemos que nos informes del problema
reveil=esta subasta es un balancing, es decir, que se produce después de dos pasos . Se puede hacer con juegos más débiles porque, si el jugador pasa, las subastas se acabarían ahí.
poc=esta subasta pide al partner que pase si he cantado su palo o, si no, que rectifique en su palo
demandemin=esta subasta pide al partner que cante su menor
demandemaj=esta subasta pide al partner que cante su mayor
majcinq=sistema de apertura en Mayor 5º, es decir, que la apertura de un mayor promete al menos 5 cartas del palo
polish=subasta del sistema polaco
mm=Mejor menor (se abre de la menor más larga o, si son iguales, de un diamante, salvo si se llevan 3 tréboles y 3 diamantes; entonces se abre de un trébol)
multi=esta subasta es artificial, muestra una mano débil a corazón o a picas
deuxpolo=esta subasta muestra una mano débil con 5 cartas del mayor cantado y un menor quinto indeterminado
deuxpolomaj=esta subasta muestra una mano bicolor con corazones y otro palo indeterminado
kquatre=sistema de apertura de Diamante 4º, es decir, la subasta de un diamante promete al menos 4 cartas
drury=esta es una subasta artificial llamada Drury. Muestra fuerza máxima estando pasado de mano y apoyo en el palo de apertura.
troisf=esta subasta es un tercer palo forcing, y muestra un problema de parada en el cuarto palo o que se está buscando un enchufe, o una mano fuerte para que la secuencia sea forcing antes de hacer un enchufe
troisfdeuxsurun=esta subasta es un tercer palo forcing: o la subasta es natural, o indica una fuerza con un problema de parada en el cuarto palo
quatriemef=esta subasta es un cuarto palo forcing que muestra un problema de parada en el palo cantado o que se está buscando un enchufe, o con una mano fuerte para hacer que la secuencia sea forcing antes de hacer un enchufe
spoutnik=esta subasta es artificial, se llama sputnik. Indica aproximadamente ocho puntos como mínimo, sin límite superior y promete por lo menos cuatro cartas de un palo aún no cantado
fortinde=esta subasta muestra una mano fuerte pero de un palo indeterminado o una mano regular de 22-23 puntos
gambling=esta subasta muestra un menor séptimo (es decir, con ARD séptimos)
landy=esta subasta es artificial, se llama Landy, muestra una mano bicolor con ambos mayores, por lo menos cuartos
deuxsafit=un enchufe en una mano invitacional de manga con 3 triunfos o una mano de manga regular de 12-14H
splinter=esta subasta es artificial, se llama Splinter, muestra una corta del palo cantado y un enchufe excelente en el último palo que haya cantado el partner
roudi=esta subasta es artificial, se llama roudi: muestra una mano que por lo menos propone la manga y pregunta al partner si lleva 3 cartas de nuestro palo
leben=esta subasta es artificial, es la convención Lebensohl: 2ST muestra una mano débil y las demás subastas, una mano fuerte
truscott=esta subasta es artificial. Es la convención Truscott. 2ST muestra una mano al menos invitativa con apoyo al palo de apertura, y apoyar a nivel de 3 muestra una mano débil.
moderateur=esta subasta es artificial, la convención 2ST moderador: por lo general, muestra una mano débil y pide al partner que repita su palo más largo con un juego mínimo
josephine=esta subasta es convencional, es la convención Josephine: pide al partner que designe el gran slam si posee dos grandes honores en el palo de triunfo; se puede también responder 6T con el As o el Rey de triunfo y un triunfo supernumerario.
josephine6T=esta respuesta es convencional, es la convención Josephine: indica el As o el Rey de triunfo y un triunfo supernumerario.
stayman=esta subasta es convencional, es la convención Stayman: pregunta al partner si lleva un mayor cuarto. Garantiza al menos con qué hacer una propuesta de manga y al menos un mayor exactamente cuarto.
staymanrep=esta subasta indica que no se llevan cuatro cartas de corazón ni cuatro cartas de picas.
texas(p1)=esta subasta es artificial, es la convención Texas: muestra una larga de %p1% sin noción de fuerza
transfert(p1)=esta subasta es un transfer que pide cantar el palo %p1% para jugar una buena mano, determina el triunfo a %p1%
bw=esta subasta es un Blackwood: pregunta al partner cuántos ases lleva
bwrois=esta subasta es un Blackwood a Reyes: pregunta al partner cuántos reyes lleva
bw(p1)=esta subasta es un Blackwood (pregunta el número de Ases) al triunfo %p1%
bwda=esta subasta pregunta al partner si lleva la Dama de triunfo
as(p1,p2)=esta subasta muestra %p1% o %p2% Ases
roi(p1,p2)=esta subasta muestra %p1% o %p2% Rey/es
clef(p1,p2)=esta subasta muestra %p1% o %p2% Clave/s. Las 5 claves son los 4 Ases + el Rey de triunfo
as(p1)=esta subasta muestra  %p1% Ases
clef(p1)=esta subasta muestra  %p1% Clave/s. Las 5 claves son los 4 Ases + el Rey de triunfo
roi(p1)=esta subasta muestra  %p1% Rey/es
ara=llevo el Rey de triunfos
sra=no llevo el Rey de triunfos
ada=Llevo la Dama de triunfos (o bien la dama de triunfos o un décimo triunfo)
sda=no llevo la Dama de triunfos
asmc=esta subasta muestra 2 Ases del mismo color (rojo o negro)
asmr=esta subasta muestra 2 Ases del mismo rango (menor o mayor)
amm=esta subasta muestra 2 Ases mezclados (ni el mismo color ni el mismo rango)
chicane=un fallo
chicane(p1)=un fallo a %p1%
ascoul(p1)=esta subasta muestra el As de %p1%
roicoul(p1)=esta subasta muestra el Rey de %p1%
asmaj=esta subasta muestra el As de Corazones o el As de Picas
ctrl=control del palo cantado (As, Rey, semifallo o fallo), lo que significa tener obligatoriamente un enchufe en otro palo. Los controles se cantan de forma económica.
ctrl(p1)=control a %p1% (As, Rey, semifallo o fallo), lo que significa tener obligatoriamente un enchufe en otro palo. Los controles se cantan de forma económica.
ttctrl=control en los palos que no son el triunfo (As, Rey, semifallo o fallo)
ctrlun=control de la primera vuelta en el palo cantado (As o fallo)
ctrlsaut=control del palo cantado (As, Rey, semifallo o fallo), sin controlar (ni As, ni Rey, ni semifallo, ni fallo) el palo saltado
ctrlsautatout=un juego mínimo o que aún no se controla (ni As, ni Rey, ni semifallo, ni fallo) el palo que se ha saltado
pbctrl(p1)=problema de control en %p1% (ni As, ni Rey, ni semifallo, ni fallo)
15-17=15-17
0-7=0-7
16-40=16+
stop = subasta sign off porque faltan dos Ases (o claves), se pide al partner que cante 5ST
entame3sa = esta subasta es un doblo de salida: indica que se quiere hacer caer a los contrincantes si el compañero realiza una salida especial; en general, se trata de un palo mayor
bwrois5clef = excepto el Rey de triunfo

[points]
_pointNoIndication=Sin datos en la zona de puntos
_pointExact(p1)=Exactamente %p1% puntos
_pointBetween(p1,p2)=Entre %p1% y %p2% puntos
_pointAlLeast(p1)=Al menos %p1% puntos
_pointAtMost(p1)=Como máximo %p1% puntos


[color]
_colorNoIndication=Sin datos
_colorExact(p1)=Exactamente %p1% cartas
_colorBetween(p1,p2)=Entre %p1% y %p2% cartas
_colorAlLeast(p1)=Al menos %p1% cartas
_colorAtMost(p1)=Como máximo %p1% cartas

