0-8 = 0-8
9-11 = 9-11
bw5clef(p1) = dette er en RKCB melding med %p1% som trumf: spør din makker om hvor mange key-cards (KC) han har med %p1% som trumf. De 5 KC er de 4 Essene og K i trumf (%p1% Konge).

[forcing]
forcing10=Meldingen er ikke krav
forcing11=Meldingen er krav
forcing12=Budet er utgangskrav
forcing13=Kravpass
forcing20=Meldingen er ikke krav
forcing21=Meldingen er krav
forcing22=Budet er utgangskrav
forcing23=Kravpass


[General]
&=og
|=eller
T=Kløver
K=Ruter
C=Hjerter
P=Spar
nat=dette er en naturlig melding
exactcoul(p1,p2)=nøyaktig %p1% korts %p2%
coul(p1,p2)=minst %p1% korts %p2%
sanscoul(p1,p2)=denne meldingen benekter %p1% korts %p2%
courte(p1)=kortfarge i %p1% (singel eller renons)
singleton(p1)=singelton i %p1%
irreg=en ubalansert hånd
reg=en balansert hånd
arret=en stopper i motpartens farge (Ess, K minst 2., D minst 3. eller J minst 4)
arret(p1)=stopper i %p1%
pb=stopper problem i fargen i en evt 3NT kontrakt. Makker bes melde 3NT med hold i fargen.
pb(p1)=stopper problem i %p1%
force(p1)=styrke i %p1%, dvs. en honnør eller en honnørkonsentrasjon
ouvsa=en balansert hånd normalt uten 5-korts major
sa=normalt en balansert hånd uten en 4-korts major som kan meldes på 1-trinnet
tolerance(p1)=preferanse for %p1%
pref=preferanse for denne fargen
pref(p1)=preferanse for %p1%
paspref=en indifferent hånd mht makkers farger
fit(p1)=støtte i %p1%
fit=støtte
fitjump=lengde i fargen (evt kun styrke) og støtte i makkers farge
sansfit=meldingen benekter tilpass
bic(p1,p2)=2-farge hånd med %p1%/%p2%
bicdeuxautres=en 2-farge hånd med de umeldte fargene
bicinde=en 2-farge hånd med den andre majorfargen og en minor
bicpolish=en 2-farge hånd med minst en majorfarge
bicsixquatre=en 2-farge hånd i de umeldte fargene, 6-korts i den laveste og 4-korts i den høyeste
maj(p1)=%p1% korts major
tricolore=en 3-farge hånd, dvs med minst 3 4-korts farger (4-4-4)
mauvaisatouts=dårlig trumf kvalitet
belle(p1,p2)=%p1% gode kort i %p2%
barrage=sperremelding, dvs. en svak hånd med lengde i fargen
canap=canapé, dvs. den siste meldte fargen er lengre enn den første
faible=en svak hånd
fort=en sterk hånd
competitif=en "kamp-om-kontrakt" melding som ikke er krav til utgang.
limite=en invitt hånd, dvs. utgang meldes kun med tillegg.
essaimanche=en hånd som kan innebære utgang vår vei
manche=en hånd god nok for utgang, men uten håp om slem
chelem=håp om slem
choixchelem=styrke til å spille slem og søker beste trumf
maxi=max hånd
mini=minimumshånd
cher=en sterk to-seter (revers, dvs. makker kan ikke preferere i din første meldte farge på 2-trinnet)
eco=økonomisk to-seter: melder en ny farge som er lavere rangert enn åpningsfargen, uten å hoppmelde
saut=hoppmelding med 2-farge hånd (dvs. du kunne ha avgitt meldingen på lavere nivå)
quantitatif=sleminvitt hvis makker har tillegg
dujeu=viser generelt tillegg mht punkter
dujeu(p1)=Meldingen viser generelt tillegg mht punkter, minimum %p1% punkter, men sier ikke noe om fordeling
f=dette er en sterk melding, dvs. makker kan ikke passe
nf=meldingen er ikke krav, dvs. makker kan passe
fp=dette er et sign-off bud, dvs. meldingen krever at makker melder pass
fm=meldingen er krav til utgang, dvs. makker kan ikke passe før utgang er nådd
appel=negativ dobling ("take-out") - viser styrke i øvrige farger
entame=meldingen ber om denne fargen i et evt oppspill hvor motparten får kontrakten
lightner=Lightner dobling. Makker annmodes om et spesielt utspill - vanligvis utspill i blindemanns farge eller evt i en renonsfarge hos makker.
entamesa=Utspillsdirigerende dobling. Du tror kontrakten kan betes dersom makker foretar et spesielt utspill, som normalt vil være å spille ut i blindemanns første meldte farge
pun=straffedobling, dvs. du tror kontrakten kan betes
pundsune=meldingen viser intensjon om å straffedoble minst en av de andre fargene
sos=meldingen er en uttaksmelding til annen trumffarge, ber makker melde langfarge
surcontre=redoblingen viser at du tror den kontrakten står og foreslår derfor for makker å passe ned redoblingen.
ambigu=dette er en hvilemelding uten spesiell betydning
cuebid=dette er et cue-bid. Melder motpartens farge og viser enten en sterk hånd eller en hånd uten et annet naturlig bud. Kan også være en hånd med et stopper problem i motpartens farge med tanke på en evt 3NT.
cuebidfit=dette er et cue-bid. Melder motpartens farge og viser støtte og en sterk hånd.
relais=dette er en hvilemelding (relay).
sansinfo=dette er et uventet bud - ingen informasjon kan gis
ras=meldingen viser ikke noe spesielt
pourjouer=meldingen er kontrakten som ser ut til å være den beste gitt aktuell meldesekvens.
obligatoire=meldingen følger makkers "instruks" (obligatorisk)
interdit=budet er ikke tillatt
bug=BUG: vennligst rapporter dette
reveil=balanseringsmelding, den er avgitt etter to passer. Kan avgis med en svakere hånd da meldingene ellers opphører hvis du passer.
poc=meldingen skal passes ned eller korrigeres til aktuell farge
demandemin=meldingen ber makker melde minorfargen sin
demandemaj=meldingen ber makker melde sin majorfarge
majcinq=5-korts majoråpninger, dvs. majoråpning viser minst 5-korts i fargen
polish=Polish Club melding
mm=Beste minor (du åpner med din lengste minor og med lik lengde åpner du med 1 ruter - dog slik at du åpner med 1 kløver med 3-3 fordeling i minor)
multi=kunstig melding, viser en svak hånd med hjerter eller spar farge
deuxpolo=svak hånd med 5-korts i meldte majorfarge og en ukjent 5-korts minor
deuxpolomaj=meldingen viser en to-seter med hjerter og en annen ukjent farge
kquatre=4-korts ruter åpningssystem, dvs. 1 ruter i åpning viser alltid minst 4-korts
drury=dette er en kunstig melding - Drury: den viser en maksimumshånd (etter pass i åpning) med støtte i makkers åpningsfarge.
troisf=meldingen er 3. meldte farge krav og er enten i) et stopper problem i den 4. (umeldte) fargen, ii) søker tilpass eller iii) generelt rundekrav med en sterk hånd
troisfdeuxsurun=meldingen er 3. meldte farge krav, dvs. er enten naturlig eller viser styrke med et stopper problem i den 4. (umeldte) fargen
quatriemef=meldingen er 4. meldte farge krav og er enten i) et stopper problem i den meldte fargen, ii) søker tilpass eller iii) generelt rundekrav med en sterk hånd
spoutnik=dette er en kunstig melding kalt Sputnik (negativ dobling). Viser 8p+ uten øvre grense og lover minst 4-korts i en ikke navngitt farge.
fortinde=meldingen viser en sterk hånd med ukjent langfarge eller en balansert hånd med 22-23HP
gambling=meldingen viser en minorfarge minimum 7-korts med EKD på topp
landy=kunstig melding - Landy: viser begge major minst 4-4
deuxsafit=en invitthånd med minst 3-korts støtte eller en balansert hånd med 12-14HP
splinter=Splinter melding - viser kortfarge og god støtte til makkers siste meldte farge
roudi=Kunstig melding - Roudi: viser mininmum en invitthånd og spør makker om han har 3-korts støtte i din farge
leben=Lebensohl - 2NT meldingen viser en svak hånd. Øvrige bud viser en sterk hånd.
truscott=dette er et kunstig bud. Dette er Truscott-konvensjonen: 2NT viser minst en invitthånd med tilpass, mens høyning av makkers farge til 3-trinnet er svak.
moderateur=Kunstig 2NT melding - viser en svak hånd og ber makker om å gjenmelde sin lengste farge med en minimumshånd.
josephine=Kunstig melding - Josephine (Grand Slam Force). Makker bes melde storeslem med to topphonører i trumffargen, mens du kan normalt skal melde 6 kløver dersom du har E eller K i trumf og (minst) ett kort til i trumffargen.
josephine6T=Kunstig melding - Josephine (Grand Slam Force); viser E eller K i trumfargen og en ekstra trumf.
stayman=Kunstig melding - Stayman; søkemelding etter 4-korts major hos makker - viser minst invitt til utgang og lover minst en (nøyaktig) 4-korts majorfarge.
staymanrep=dette budet benekter 4-korts majorfarge.
texas(p1)=Overføring (Jacoby) - viser lengde i %p1% og sier ingenting om styrken.
transfert(p1)=Overføring - ber makker melde %p1% slik at åpneren blir spillefører, dvs. %p1% skal normalt være trumf.
bw=Blackwood - spørsmål om antall Ess.
bwrois=Blackwood - spørsmål om antall konger.
bw(p1)=Blackwood (spørsmål om antall Ess) med %p1% som trumf
bwda=makker bes melde av evt trumf Dame.
as(p1,p2)=meldingen viser %p1% eller %p2% Ess
roi(p1,p2)=meldingen viser %p1% eller %p2% Konger
clef(p1,p2)=meldingen viser %p1% eller %p2% key card(s), hvor de 5 KC er de 4 Essene pluss trumf K
as(p1)=meldingen viser %p1% Ess
clef(p1)=meldingen viser %p1% key-card(s), hvor de 5 KC er de 4 Essene pluss trumf K.
roi(p1)=meldingen viser %p1% Konge(r)
ara=jeg har trumf K
sra=jeg har ikke trumf K
ada=Jeg har kontroll på trumf D (enten i form av trumf D eller i form av den 10. trumfen)
sda=jeg har ikke trumf D
asmc=viser 2 Ess med samme farge (rødt eller svart)
asmr=viser de 2 minor Essene eller de to major Essene
amm=viser 2 Ess som ikke har samme farge (rød/svart) og som heller ikke er av samme rang (minor/major)
chicane=renons
chicane(p1)=renons i %p1%
ascoul(p1)=viser %p1% Ess
roicoul(p1)=viser %p1% Konge
asmaj=viser Esset i en av majorfargene
ctrl=kontroll i fargen (E, K, singel eller renons) - tilpass i annen farge. Kontrollmeldinger avgis økonomisk.
ctrl(p1)=kontroll i %p1% (E, K, singel eller renons) - tilpass i annen farge. Kontrollmeldinger avgis økonomisk.
ttctrl=kontroll i alle farger bortsett fra trumf (Ess, K, singel eller renons)
ctrlun=førstekontroll i fargen (Ess eller renons)
ctrlsaut=konroll i meldte farge (Ess, K, singel eller renons) og ingen kontroll i underliggende farge (verken Ess, K, singel eller renons)
ctrlsautatout=enten en minimumshånd eller mangel på kontroll i underliggende farge (verken Ess, K, singel eller renons)
pbctrl(p1)=mangler kontroll i %p1% (verken Ess, K, singel eller renons)
15-17=15-17
0-7=0-7
16-40=16+
stop = sign-off melding fordi 2 Ess (eller to key-cards) mangler, ber makker om å melde 5NT
entame3sa = Utspillsdirigerende dobling. Du tror kontrakten kan betes dersom makker foretar et spesielt utspill : generelt betyr det en majorfarge
bwrois5clef = ikke medregnet trumf K

[points]
_pointNoIndication=Sier ingenting om styrke
_pointExact(p1)=Nøyaktig %p1% punkter
_pointBetween(p1,p2)=Mellom %p1% og %p2% punkter
_pointAlLeast(p1)=Minst %p1% punkter
_pointAtMost(p1)=Max %p1% punkter


[color]
_colorNoIndication=Ingen indikasjon
_colorExact(p1)=Nøyaktig %p1% korts
_colorBetween(p1,p2)=Mellom %p1% og %p2% korts
_colorAlLeast(p1)=Minimum %p1% korts
_colorAtMost(p1)=Max %p1% korts

