0-8 = 0-8
9-11 = 9-11
bw5clef(p1) = ta odzywka to Blackwood na 5 wartości przy atucie %p1%: pyta partnera o ilość wartości przy atucie %p1%. 5 wartościami są 4 Asy + król atutowy (król %p1%).

[forcing]
forcing10=Odzywka "Nie forsująca"
forcing11=Odzywka "Forsująca"
forcing12=Odzywka "Forsing do dogranej"
forcing13=Odzywka "zamykająca"
forcing20=Odzywka "Nie forsująca"
forcing21=Odzywka "Forsująca"
forcing22=Odzywka "Forsing do dogranej"
forcing23=Odzywka "zamykająca"


[General]
&=i
|=albo
T=Trefl
K=Karo
C=Kier
P=Pik
nat=długość w zapowiedzianym kolorze
exactcoul(p1,p2)=dokładnie %p1% kart w %p2%
coul(p1,p2)=co najmniej %p1 kart w %p2%
sanscoul(p1,p2)=ta zapowiedź wyklucza %p1% kart w %p2%
courte(p1)=krótkość w %p1% (singiel lub renons)
singleton(p1)=singleton w %p1%
irreg=ręka niezrównoważona
reg=ręka zrównoważona
arret=zatrzymanie w kolorze przeciwnika (As, co najmniej drugi król, co najmniej trzecia dama albo co najmniej czwarty walet)
arret(p1)=zatrzymanie w %p1%
pb=problem z zatrzymaniem w zgłoszonym kolorze do gry 3 BA, partner zapowie 3 BA z siłą w kolorze.
pb(p1)=problem z zatrzymaniem w %p1%
force(p1)=siła w %p1%, to jest figura albo koncentracja figur
ouvsa=ręka zrównoważona w zasadzie bez starszej piątki
sa=ręka zrównoważona bez starszej czwórki do zapowiedzenia na poziomie 1
tolerance(p1)=tolerancja dla %p1%
pref=preferencja dla zapowiedzianego koloru
pref(p1)=preferencja dla %p1%
paspref=ręka bez preferencji dla kolorów partnera
fit(p1)=fit w %p1%
fit=fit
fitjump=długość w zapowiedzianym kolorze (wyjątkowo siła) oraz fit w kolorze partnera
sansfit=ta zapowiedź neguje fit
bic(p1,p2)=dwukolorówka %p1%/%p2%
bicdeuxautres=dwukolorówka pozostałych kolorów
bicinde=dwukolorówka z drugim starszym i nieznanym młodszym
bicpolish=nieokreślona dwukolorówka z przynajmniej jednym starszym
bicsixquatre=dwukolorówka obu innych, sześć kart w najmłodszym i cztery karty w najstarszym
maj(p1)=%p1% kart w starszym
tricolore=trójkolorówka, to jest co najmniej trzy kolory czterokartowe
mauvaisatouts=słaba jakość atutów
belle(p1,p2)=%p1% bardzo ładnych kart w %p2%
barrage=odzywka zaporowa w kolorze to jest ręka słaba honorowo z ładnym długim kolorem
canap=kanapa, drugi kolor dłuższy od pierwszego
faible=słaba ręka
fort=silna ręka
competitif=ręka bez nadwyżek, to nie jest próba dogranej, a tylko odzywka mająca na celu niedopuszczenie do gry przeciwników.
limite=ręka zachęcająca do dogranej w razie nadwyżek.
essaimanche=ręka z nadzieją na dograną
manche=ręka wystarczająca do dogranej bez nadziei na szlemika
chelem=ambicje szlemikowe
choixchelem=siła na szemika, poszukiwanie najlepszego koloru atutowego
maxi=ręka maksimum
mini=ręka minimum
cher=rewers (nie można wrócić na pierwszy kolor otwierajacego na poziomie dwóch)
eco=dwukolorówka ekonomiczna: zgłoszenie bez skoku koloru niższego od koloru otwarcia
saut=dwukolorówka z przeskokiem (to znaczy, że można było zgłosić kolor o stopień niżej)
quantitatif=propozycja zagrania szlemika jeśli partner nie ma minimum
dujeu=nadwyżka punktowa bez sprecyzowania
dujeu(p1)=odzywka ta pokazuje nadwyżkę, przynajmniej %p1% punktów, bez szczegółów co do rozkładu.
f=forsing, partner nie może spasować gdy przyjdzie na niego kolej
nf=odzywka nie forsująca, gdy przyjdzie na niego kolej, partner może spasować
fp=to jest sign off, odzywka kończąca licytację, partner ma obowiązek spasować gdy przyjdzie na niego kolej
fm=forsing do dogranej, partner nie może spasować przed dograną
appel=odzywka wywoławcza, wskazuje na poparcie w pozostałych kolorach
entame=ta odzywka żąda wistu w ten kolor jeśli przeciwnicy wygrają licytację i jeśli partner wistuje
lightner=kontra lightnera : żąda szczególnego wistu, na ogół pierwszy kolor dziadka albo poszukiwanie renonsu
entamesa=kontra wistowa : wskazuje że można położyć przeciwników jeśli partner zawistuje w sposób szczególny, na ogół chodzi o pierwszy kolor dziadka
pun=kontra karna, mamy nadzieję na położenie przeciwników
pundsune=ta odzywka wskazuje na chęć kontry karnej przynajmniej w jednym z pozostałych kolorów
sos=SOS, żąda od partnera innego koloru
surcontre=ta zapowiedź oznacza że oceniamy że wygramy skontrowany kontrakt i proponujemy partnerowi aby spasował.
ambigu=odzywka wyczekująca, nie wskazuje niczego szczególnego
cuebid=cue-bid, polega to na zapowiedzi w kolor przeciwnika i wskazuje silną rękę bez naturalnej odzywki, czasami wskazuje na problem z zatrzymaniem w tym kolorze do bez atu
cuebidfit=cue-bid, odzywka w kolor przeciwników, tu pokazuje fit w silnej ręce
relais=relay : odzywka wyczekująca
sansinfo=to nie jest przewidziana odzywka, nie wnosi zatem żadnej informacji
ras=nic specjalnego
pourjouer=najlepszy kontrakt do gry wynikajacy z danej sekwencji
obligatoire=zapowiedź obowiązkowa
interdit=odzywka zabroniona
bug=błąd : dziękujemy za zawiadomienie o powstałym problemie
reveil=odzywka ożywiająca, dokonana po dwóch pasach. Może być ze słabszą ręką bo gdy gracz spasuje, licytacja się zakończy.
poc=ta odzywka domaga sie pasa od partnera jeśli wymieniłem jego kolor a jesli nie aby poprawił na swój kolor
demandemin=ta odzywka domaga sie od partnera zgłoszenia jego młodszego koloru
demandemaj=ta odzywka domaga sie od partnera zgłoszenia jego starszego koloru
majcinq=Otwarcie w systemie starszy z piątki, otwarcie w starszym kolorze obiecuje 5 kart
polish=System polski
mm=Lepszy młodszy (otwiera się w najdłuższym młodszym a przy równości długości otwiera się 1 karo chyba że mamy 3 trefle i 3 kara wtedy otwieramy 1 trefl)
multi=Odzywka sztuczna, pokazuje słabą rękę z kierami lub pikami
deuxpolo=Ta odzywka pokazuje słabą rękę z 5 kartami w starszym i 5 w nieznanym młodszym
deuxpolomaj=ta odzywka pokazuje dwukolorówkę z kierami i innym nieznanym kolorem
kquatre=system oparty o otwarcie 1 karo z czwórki, 1 karo obiecuje co najmniej 4 karty w karach
drury=to jest odzywka sztuczna, tzw. Drury, pokazuje rękę po pasie, maksimum z fitem w kolorze otwarcia
troisf=trzeci kolor forsing pokazujący albo problem z zatrzymaniem w czwartym kolorze, albo poszukiwanie fitu, albo silną rękę tak by sekwencja była forsing przed sfitowaniem
troisfdeuxsurun=trzeci kolor forsing: albo odzywka jest naturalna, albo pokazuje wartości wraz z problemem z zatrzymaniem w czwartym kolorze
quatriemef=czwarty kolor forsing pokazujący albo problem z zatrzymaniem w mianowanym kolorze, albo poszukiwanie fitu, albo silną rękę aby sekwencja była forsing przed sfitowaniem
spoutnik=odzywka sztuczna "sputnik", pokazuje minimum 8 punktów i obiecuje co najmniej 4 karty w kolorze do tej pory nie zgłoszonym
fortinde=silna ręka na nieznanym kolorze albo ręka zrównoważona 22-23 punkty
gambling=Samodzielny kolor młodszy (z AKD)
landy=odzywka sztuczna, "Landy", dwa kolory starsze, przynajmniej czwórki
deuxsafit=Fit w ręce propozycyjnej z 3 atutami albo ręka do dogranej 12-14 p.
splinter=Odzywka sztuczna, "Splinter", pokazuje krótkość w kolorze i duży fit w ostatnim kolorze zgłoszonym przez partnera
roudi=odzywka sztuczna "magister" : pokazuje rękę przynajmniej propozycyjną do dogranej i pyta partnera czy ma 3 karty w naszym kolorze
leben=odzywka sztuczna, to konwencja "Lebensohl": 2BA pokazuje rękę słabą, inne odzywki pokazują rękę silną
truscott=to jest odzywka sztuczna. To konwencja "Truscott". 2BA pokazuje rękę co najmniej inwitującą z fitem, a fit na poziomie 3 pokazuje rękę słabą
moderateur=odzywka sztuczna, to konwencja 2BA słabe: na ogół pokazuje słabą rękę i prosi partnera o powtórzenie jego najdłuższego koloru z ręką słabą
josephine=odzywka konwencyjna: żąda od partnera aby zgłosił wielkiego szlema jeśli ma dwa górne honory w kolorze atutowym. Można również odpowiedziec 6T z Asem lub Królem atutowym i dodatkowym atutem.
josephine6T=odzywka konwencyjna Josephine: wskazuje na Asa lub Króla atutowego i dodatkowy atut.
stayman=odzywka konwencyjna Stayman: pyta partnera czy posiada starszą czwórkę, gwarantuje przynajmniej propozycje dogranej oraz jedną starszą czwórkę.
staymanrep=Ta odzywka wskazuje, że nie mamy ani 4 kierów ani 4 pików.
texas(p1)=odzywka sztuczna, konwencja Texas: wskazuje długość w %p1% bez żadnej infomacji co do siły
transfert(p1)=odzywka jest transferem, żąda zgłoszenia %p1% aby grać z dobrej ręki, ustala atut w %p1%
bw=to jest Blackwood: pyta partnera ile ma Asów
bwrois=to jest pytanie o króle: partner ma wskazać ile ma króli
bw(p1)=To jest Blackwood (pytanie o Asy) przy atucie %p1%
bwda=pytanie o damę atu
as(p1,p2)=Ta odzywka pokazuje %p1% albo %p2% Asy
roi(p1,p2)=Ta odzywka pokazuje %p1% albo %p2% Króle
clef(p1,p2)=ta odzywka pokazuje %p1% albo %p2% wartości. Wartości to 4 Asy i król atu
as(p1)=ta odzywka pokazuje %p1% As(y)
clef(p1)=ta odzywka pokazuje %p1% wartość(ci) z pięciu (Asy i król atu)
roi(p1)=ta odzywka pokazuje %p1% Króla(e)
ara=mam króla atu
sra=nie mam króla atu
ada=Mam Damę atu (albo damę atu albo dziesiąte atu)
sda=nie mam Damy atu
asmc=2 Asy tego samego koloru
asmr=2 Asy tej samej rangi
amm=2 Asy mieszane
chicane=Użyteczny renons
chicane(p1)=Renons w %p1%
ascoul(p1)=As w %p1%
roicoul(p1)=król w %p1%
asmaj=As kier albo As pik
ctrl=kontrola w danym kolorze (As, Król, singiel albo renons), oznacza to koniecznie fit w innym kolorze, kontrole pokazuje się w sposób ekonomiczny
ctrl(p1)=kontrola w %p1% (As, król, singiel albo renons), oznacza to koniecznie fit w innym kolorze, kontrole pokazuje sie w sposób ekonomiczny
ttctrl=kontrole we wszystkich kolorach poza atutowym  (As, król, singiel albo renons)
ctrlun=kontrola pierwszego okrążenia w danym kolorze (As albo renons)
ctrlsaut=albo ręka minimum albo brak kontroli (ani As, ani król, ani singiel ani renons) w przeskoczonym kolorze
ctrlsautatout=albo ręka minimalna, albo brak kontroli (brak Asa, Króla, renonsu albo singletona) w kolorze przeskoczonym
pbctrl(p1)=problem z kontrolą w %p1% (ani As, ani król, ani singiel ani renons)
15-17=15-17
0-7=0-7
16-40=16+
stop = odzywka hamująca bo brak dwóch Asów (lub wartości), żąda od partnera zgłoszenia 5BA
entame3sa = kontra wistowa : wskazuje że można położyć przeciwników jeśli partner zawistuje w sposób szczególny, na ogół chodzi o wist w kolor starszy
bwrois5clef = za wyjątkiem króla atutowego

[points]
_pointNoIndication=Brak wskazówek co do siły
_pointExact(p1)=Dokładnie %p1% punktów
_pointBetween(p1,p2)=Między %p1% a %p2% punktów
_pointAlLeast(p1)=Co najmniej %p1% punktów
_pointAtMost(p1)=Najwyżej %p1% punktów


[color]
_colorNoIndication=Brak wskazówek
_colorExact(p1)=Dokładnie %p1% kart
_colorBetween(p1,p2)=Pomiędzy %p1% a %p2% kart
_colorAlLeast(p1)=Przynajmniej %p1% kart
_colorAtMost(p1)=Najwyżej %p1% kart

