0-8 = 0-8
9-11 = 9-11
bw5clef(p1) = questa è la dichiarazione RKCB con %p1% come atout: chiede al compagno quante carte chiave egli abbia in mano con atout %p1%. Le 5 carte chiave sono i 4 Assi e il Re d'atout (Re di %p1%).

[forcing]
forcing10=Licita "non forzante"
forcing11=Licita "forzante"
forcing12=Licita "forzante manche"
forcing13="Passo forzante"
forcing20=Licita "non forzante"
forcing21=Licita "forzante"
forcing22=Licita "forzante manche"
forcing23="Passo forzante"


[General]
&=e
|=o
T=Fiori
K=Quadri
C=Cuori
P=Picche
nat=Licita naturale
exactcoul(p1,p2)=%p1% carte a %p2%
coul(p1,p2)=almeno %p1% carte a %p2%
sanscoul(p1,p2)=questa licita nega %p1% carte a %p2%
courte(p1)=una corta a %p1% (un singolo o una chicane)
singleton(p1)=un singolo a %p1%
irreg=una mano sbilanciata
reg=una mano bilanciata
arret=un fermo nel colore avversario (l'Asso, il Re almeno secondo, la Dama almeno terza o il Fante almeno quarto)
arret(p1)=un fermo a %p1%
pb=un problema di fermo nel colore annunciato. Il compagno risponde 3SA con fermo nel colore.
pb(p1)=un problema di fermo a %p1%
force(p1)=forza a %p1%, cioè un onore o una concentrazione d'onori
ouvsa=una mano bilanciata senza quinte nobili
sa=una mano bilanciata o semibilanciata senza quarte nobili nominabili a livello di 1
tolerance(p1)=tolleranza per le %p1%
pref=preferenza per il colore annunciato
pref(p1)=preferenza per le %p1%
paspref=una mano senza preferenza tra i colori del compagno
fit(p1)=fit a %p1%
fit=fit
fitjump=una lunga nel colore annunciato (eccezionalmente forza senza lunga) con anche un fit nel colore del compagno
sansfit=questa dichiarazione nega un fit
bic(p1,p2)=una bicolore %p1%/%p2%
bicdeuxautres=una bicolore dei due colori non ancora dichiarati
bicinde=una bicolore con l'altro nobile e un minore indeterminato
bicpolish=una bicolore indeterminata con almeno una nobile
bicsixquatre=una bicolore in due colori non dichiarati, sei carte nel colore meno nobile e 4 carte nel colore più nobile
maj(p1)=%p1% carte nel nobile
tricolore=un gioco tricolore, cioè con almeno tre colori quarti
mauvaisatouts=una cattiva qualità delle atouts
belle(p1,p2)=%p1% buone carte a %p2%
barrage=un barrage nel colore dichiarato, cioè una mano debole in punti con un bel colore lungo
canap=un canapé, cioè il secondo colore è più lungo del primo
faible=una mano debole
fort=una mano forte
competitif=una dichiarazione competitiva per non lasciare giocare gli avversari. Attento! In questo caso, non è forzante manche.
limite=una mano invitante, cioè si chiuderà a manche con il massimo.
essaimanche=una mano con una speranza di giocare la manche
manche=una mano per giocare la manche senza speranza di slam
chelem=speranza di slam
choixchelem=la forza per giocare uno slam e ricerca della migliore atout
maxi=una mano massima
mini=una mano minima
cher=una bicolore forte (cioè non si può ritornare al primo colore dell'apertore al livello di 2)
eco=una bicolore economica: un nuovo colore che è di rango più basso rispetto al seme d'apertura, nominato senza salto
saut=una bicolore a salto (cioè si sarebbe potuto annunciare il colore a un livello inferiore)
quantitatif=una proposta di giocare uno slam se il partner non è minimo
dujeu=una riserva di punti senza altre precisazioni
dujeu(p1)=Questa dichiarazione mostra almeno %p1% punti, ma senza precisazioni sulla distribuzione
f=questa dichiarazione è forzante, cioè il compagno non ha il diritto di passare al suo prossimo turno di dichiarazione
nf=questa dichiarazione non è forzante, cioè il compagno ha il diritto di passare al suo prossimo turno di dichiarazione
fp=questa è una dichiarazione di stop, cioè il compagno ha il dovere di passare al suo prossimo turno di dichiarazione
fm=questa dichiarazione è forzante di manche, cioè il compagno non ha il diritto di passare finchè la manche non è stata raggiunta
appel=questa dichiarazione è informativa, essa indica un appoggio nei colori diversi da quelli dichiarati dagli avversari.
entame=questa dichiarazione chiede al compagno d'attaccare in questo colore se gli avversari vincono la dichiarazione e se è lui che deve attaccare
lightner=questa dichiarazione è un contro Lightner: chiede al compagno di fare un attacco speciale, come attaccare nel primo colore del morto o cercare una chicane
entamesa=questa dichiarazione è un contro per l'attacco: indica che si pensa d'impedire agli avversari di realizzare il contratto se il compagno fa un attacco speciale, in generale si tratta del primo colore dichiarato dal morto
pun=questa dichiarazione è punitiva, cioè indica che si pensa che gli avversari non riusciranno a realizzare il contratto
pundsune=questa dichiarazione mostra la voglia di punire almeno in uno dei colori rimanenti
sos=questa dichiarazione ha per scopo di cambiare il colore d'atout: chiede al compagno di nominare un colore lungo
surcontre=questa dichiarazione indica che si pensa di fare il contratto che è stato contrato e propone al compagno di passare sul surcontro
ambigu=questa dichiarazione è una dichiarazione d'attesa e non indica niente di particolare
cuebid=questa dichiarazione è una cue-bid, consiste nel dichiarare il colore degli avversari e mostra sia una mano forte sia una mano senza una dichiarazione naturale a disposizione. Mostra talvolta un problema di fermo in questo colore per giocare a Senza-atout.
cuebidfit=questa dichiarazione è una cue-bid, consiste nel dichiarare il colore degli avversari. Qui mostra un fit con una mano forte
relais=questa dichiarazione è un relais: una dichiarazione d'attesa
sansinfo=questa dichiarazione non è prevista e non apporta nuove informazioni
ras=questa dichiarazione non indica niente di particolare
pourjouer=questa dichiarazione indica il contratto che sembra il migliore da giocare secondo le informazioni avute dalla sequenza delle dichiarazioni
obligatoire=questa dichiarazione è una rettifica obbligatoria
interdit=questa dichiarazione è formalmente vietata
bug=BUG: per favore segnalateci questo problema
reveil=questa dichiarazione è una riapertura, cioè è fatta dopo due passo. Può essere fatta con delle mani più deboli perché se il giocatore passasse la dichiarazione terminerebbe.
poc=questa dichiarazione domanda al compagno di passare se è il suo colore il suo colore, altrimenti di correggere nel suo colore
demandemin=questa dichiarazione chiede al compagno di nominare il suo minore
demandemaj=questa dichiarazione chiede al compagno di nominare il suo nobile
majcinq=sistema d'apertura Quinta nobile, cioè l'apertura in un nobile promette 5 carte
polish=risposta del sistema polacco
mm=Miglior minore (si apre col più lungo dei minori. A parità di lunghezza si apre di 1 Quadri eccetto con 3 Fiori e 3 Quadri nel qual caso si apre di 1 Fiori)
multi=questa dichiarazione è artificiale, mostra una mano debole o con le  Cuori o con le Picche
deuxpolo=questa dichiarazione mostra una mano debole con 5 carte nel nobile e un minore quinto non specificato
deuxpolomaj=questa dichiarazione mostra una mano bicolore con le Cuori e un altro colore non specificato
kquatre=sistema d'apertura Quadri quarto, cioè l'apertura di 1 Quadri promette almeno 4 carte
drury=questa dichiarazione è una convenzione chiamata Drury, mostra una mano passata con valori massimi e fit nel colore d'apertura
troisf=questa dichiarazione è un terzo colore forzante che mostra o un problema di fermo nel quarto colore, o la ricerca di un fit, o una mano forte per rendere la sequenza forzante prima di dare il fit
troisfdeuxsurun=questa dichiarazione è un terzo colore forzante: o la dichiarazione è naturale, o indica una forza con un problema di fermo nel quarto colore
quatriemef=questa dichiarazione è un quarto colore forzante che mostra o um problema di fermo nel colore annunciato, o la ricerca d'un fit, o una mano forte per rendere la sequenza forzante prima di dare il fit
spoutnik=questa dichiarazione è una convenzione chiamata Sputnik: indica 8+ punti senza limite superiore e promette almeno quattro carte in un colore non ancora dichiarato
fortinde=questa dichiarazione mostra una mano forte in un colore indeterminato o una mano bilanciata con 22-23 punti
gambling=questa dichiarazione mostra un minore chiuso (cioè comandato da ARD)
landy=questa dichiarazione è una convenzione chiamata Landy, mostra una mano bicolore con entrambi i nobili almeno quarti
deuxsafit=fit in una mano invitante con 3 atout o una mano bilanciata da manche con 12-14 pti
splinter=questa dichiarazione una convenzione chiamata Splinter, mostra una corta nel colore dichiarato e un buon fit nell'ultimo colore dichiarato dal partner
roudi=questa dichiarazione è una convenzione chiamata Roudi: mostra una mano almeno invitante a manche e chiede al compagno se possiede 3 carte nel nostro colore
leben=questa dichiarazione è una convenzione chiamata Lebensohl: 2SA mostra una mano debole, le altre dichiarazioni mostrano una mano forte
truscott=questa dichiarazione è una convenzione chiamata Truscott: 2SA mostra una mano almeno invitante con fit, e il fit a livello di 3 mostra una mano debole
moderateur=questa dichiarazione è una convenzione chiamata 2SA scrambled: mostra in generale una mano debole e chiede al compagno di licitare il suo colore più lungo con una mano minima
josephine=questa dichiarazione è una convenzione chiamata Joséphine (Grand Slam Force): chiede al compagno di dichiarare il grande slam se egli possiede due onori maggiori nel colore d’atout. Si può anche rispondere 6 Fiori con l'Asso o il Re d'atout e un'atout in più rispetto a quanto licitato in precedenza.
josephine6T=questa risposta è convenzionale, parte della convenzione Joséphine (Grand Slam Force): essa indica l'Asso o il Re d'atout e un'atout in più rispetto a quanto licitato in precedenza.
stayman=questa dichiarazione è una convenzione chiamata Stayman: chiede al compagno se egli possiede una quarta nobile, garantisce almeno una mano invitante a manche
staymanrep=questa dichiarazione indica che non si possiedono né quattro carte a Cuori, né quattro carte a Picche.
texas(p1)=questa dichiarazione è una convenzione chiamata transfer di Jacoby: indica una lunga a %p1% senza alcuna indicazione sulla forza
transfert(p1)=questa dichiarazione è una transfer che chiede di dichiarare le %p1% per giocare dal lato della mano forte. Fissa l'atout a %p1%.
bw=questa dichiarazione è una Blackwood: chiede al compagno il suo numero di Assi
bwrois=questa dichiarazione è una Blackwood per i Re: chiede al compagno il suo numero di Re.
bw(p1)=questa dichiarazione è una Blackwood (domanda il numero d'Assi) per l'atout %p1%
bwda=questa dichiarazione chiede se il compagno possiede la Dama d'atout
as(p1,p2)=questa dichiarazione mostra %p1% o %p2% Assi
roi(p1,p2)=questa dichiarazione mostra %p1% o %p2% Re
clef(p1,p2)=questa dichiarazione mostra %p1% o %p2% Key Cards. Le 5 Key Cards sono i 4 Assi e il Re d'atout.
as(p1)=questa dichiarazione mostra %p1% Assi
clef(p1)=questa dichiarazione mostra %p1% Key Cards. Le 5 Key Cards sono i 4 Assi e il Re d'atout.
roi(p1)=questa dichiarazione mostra %p1% Re
ara=Ho il Re d'atout
sra=Non ho il Re d'atout
ada=Ho la Dama d'atout (o la Dama d'atout o una decima atout)
sda=Non ho la Dama d'atout
asmc=questa mostra 2 Assi dello stesso colore (rosso o nero)
asmr=questa mostra 2 Assi dello stesso rango (minori o nobili)
amm=questa mostra 2 Assi misti (né dello stesso colore né dello stesso rango)
chicane=una chicane
chicane(p1)=una chicane a %p1%
ascoul(p1)=questa dichiarazione mostra l'Asso di %p1%
roicoul(p1)=questa dichiarazione mostra il Re di %p1%
asmaj=questa dichiarazione mostra l'Asso di Cuori o l'Asso di Picche
ctrl=un controllo nel colore dichiarato (l'Asso, il Re, un singolo o una chicane), questo implica d'avere necessariamente un fit in un altro colore, i controlli si dichiarano al livello più economico possibile.
ctrl(p1)=un controllo a %p1% (l'Asso, il Re, un singolo o una chicane), questo implica d'avere necessariamente un fit in un altro colore, i controlli si dichiarano al livello più economico possibile
ttctrl=un controllo in tutti i colori tranne l'atout  (l'Asso, Il Re, un singolo o una chicane)
ctrlun=un controllo di primo giro nel colore dichiarato (l'Asso o una chicane)
ctrlsaut=Si controlla il colore dichiarato (Asso, Re, signolo, chicane) ma non si controllano i colori saltati
ctrlsautatout=o una mano minima o mancanza di un controllo (né Asso, né Re, né singolo né chicane) nel colore saltato
pbctrl(p1)=nessun controllo a %p1% (né Asso, né Re, né singolo né chicane)
15-17=15-17
0-7=0-7
16-40=16+
stop = dichiarazione di stop in quanto mancano 2 Assi (o keycards), chiede al partner di licitare 5SA
entame3sa = questa dichiarazione è un contro per l'attacco: indica che si pensa d'impedire agli avversari di realizzare il contratto se il compagno fa un attacco speciale, solitamente in un nobile
bwrois5clef = eccetto il Re d'atout

[points]
_pointNoIndication=Nessuna indicazione sul range di punti
_pointExact(p1)=Esattamente %p1% punti
_pointBetween(p1,p2)=Tra %p1% e %p2% punti
_pointAlLeast(p1)=Almeno %p1% punti
_pointAtMost(p1)=Al massimo %p1% punti


[color]
_colorNoIndication=Nessuna indicazione
_colorExact(p1)=Esattamente %p1% carte
_colorBetween(p1,p2)=Tra %p1% e %p2% carte
_colorAlLeast(p1)=Almeno %p1% carte
_colorAtMost(p1)=Al massimo %p1% carte

